013	'nYl-dEr-tin
1	'en
19	'ne-x@n-tin
2013	'twe-dE+-zen-der-tin
2030	'twe-dE+-zen-der-t@x
24/7	'twEn-tI-fA+r-sE-v@n
280	'twe-hOn-d@rt-Ax-t@x
281	'twe-hOn-d@rt-en-@n-tAx-t@x
3d	'dri-de
3fm	'dri-Ef-Em
80	'tax-t@x
a	'a
Ã 	'a
a-a-alles	'A-A-Al-@s
a-aangezien	'aan-G@-zin
a-afgemeld	a-'af-G@-mElt
a-als	A-'Als
aan	'an
aanbieding	'am-bi-dIN
aanbouw	'am-bA+w
aandacht	'an-dAxt
a-andere	A-'An-d@-r@
aandoet	'an-dut
aandraaien	'an-drA-j@n
aangeboden	'aN-G@-bo-d@
aangegeven	'aN-G@-Ge-v@
aangehaald	'aN-G@-halt
aangemeld	'aN-G@-mElt
aangepast	'aN-G@-pAst
aangeschoten	'aN-G@-sxo-t@
aangeven	'aN-Ge-v@
aangevraagd	'aN-G@-vraxt
aangezien	'aN-G@-zin
aanklikken	'aN-klI-k@
aankomen	'aN-ko-m@
aanmaken	'an-ma-k@
aanmaning	'an-man-IN
aannemen	'a-ne-m@
aanraken	'an-ra-k@
aanschaf	'an-sxAf
aanslaat	'an-slat
aansluit	'an-slY+t
aansluiten	'an-slY+-t@
aansnijden	'an-snE+-d@
aanspreekt	'an-sprekt
aanstaande	'an-stan-d@
aantal	'an-tAl
aantrekken	'an-trE-k@
aanvang	'an-vAN
aanvragen	'an-vra-G@
aanwezig	an-'we-z@x
aanzet	'an-zEt
aanzetten	'an-zE-t@
aanzuigen	'an-zY+-Gn
aap	'ap
aardappelsalade	'ard-A-p@l-sa-la-d@
aardig	'ar-d@x
a-arends	a-'a-r@nds
aas	'as
abn	'a-be-En
absoluut	Ap-so-'lyt
abstract	Ap-'strAkt
abstracte	Ap-'strAk-t@
abstractere	Ap-'strAk-t@-r@
absuut	Ap-'syt
ac	'a-se
ac-	'Ak
academische	a-ka-'de-mi-s@
accent	Ak-'sEnt
accepteert	Ak-sEp-'tert
accountants	A-'kA+n-t@nts
accountantskantoren	A'-kA+n-tEnts-kAn-to-r@n
accounting	A-'kA+n-tIN
accu	'A-ky
accuracy	A-'kjY-ra-sI
ach	'Ax
acht	'Axt
achten	'Ax-t@
achten-	'ax-t@n
achtentwintig	'Axt-En-twIn-t@x
achtentwintigste	'Axt-En-twIn-t@x-st@
achter	'Ax-t@r
achteraan	Ax-t@r-'an
achteraf	Ax-t@r-'Af
achteren	'Ax-t@-r@
achtergrond	'Ax-t@r-GrOnt
achtergronden	'Ax-t@r-GrOn-d@
achterhoek	'Ax-t@r-huk
achterin	Ax-t@r-'In
achterlijk	'Ax-t@r-l@k
achterna	Ax-t@r-'na
achterop	Ax-t@r-'Op
achterover	Ax-t@r-'o-v@r
achteruit	Ax-t@r-'Y+t
achterwaartse	'Ax-t@r-wart-s@
achtig	'Ax-t@x
achtige	'Ax-tiG-@
achttien	'Ax-tin
achttiende	'Ax-tin-d@
acteur	Ak-'t2r
acteurs	Ak-'t2rs
action	'Ak-SOn
activiteit	Ak-ti-vi-'tE+t
activiteiten	'Ak-ti-vi-tE+-t@
adem	'a-d@m
adem-	'a-dEm
ademhaalt	'a-d@m-halt
ademhaling	'a-d@m-ha-lIN
ademhalingspatroon	'a-d@m-ha-lINs-pA-tron
aderen	'a-d@-r@
adobe	'a-dO-b@
advanced	Ad-'vanst
adviestaak	At-'vis-tak
adviseren	At-fi-'ze-r@
advocaat	At-fo-'kat
af	'Af
af-	'Af
afbekt	'Av-bEkt
afblijven	'Av-blE+-v@
afdele	af-'delI
afdoende	Av-'dun-d@
afgekocht	'Af-x@-kOxt
afgelopen	'Af-x@-lo-p@
afgemaakt	'Af-x@-makt
afgeragd	'Af-x@-'rAxt
afgerond	'Af-x@-rOnt
afgeschaft	'Af-x@-sxAft
afgesloten	'Af-x@-slo-t@
afgesproken	'Af-x@-spro-k@
afgestemd	'Af-x@-stEmt
afgewogen	'Af-x@-wo-G@
afhaken	'Af-ha-k@
afkloppen	'Af-klO-p@
afkomen	'Af-ko-m@
afkortingen	'Af-kOr-tI-N@
afleidende	'Af-lE+-d@n-d@
afleidt	'Af-lE+t
aflever	'Af-le-v@r
aflevering	'Af-le-v@-rIN
afleveringen	'Af-le-v@-rI-N@
aflikken	'Af-lI-k@n
afmaken	'Af-ma-k@
afrekening	'Af-re-k@-nIN
afrikanen	a-fri-'ka-n@
afschaffen	'Af-sxA-f@
afschuwelijk	Af-'sxy-w@-l@k
afschuwelijke	Af-'sxy-w@-l@-k@
afsluiten	'Af-slY+-t@
afsluiting	'Af-slY+-tIN
afspraak	'Af-sprak
afspraak-	'Af-sprak
afspreken	'Af-spre-k@
afstappen	'Af-stA-p@
afstudeerfeest	'Af-sty-der-fest
afstuderen	'Af-sty-de-r@
afwachten	'Af-wAx-t@
afwas	'Af-wAs
afwassen	'Af-wA-s@
afwasspu-	'Af-wA-spY
afwerken	'Af-wEr-k@
afwisseling	'Af-wI-s@-lIN
afzeggen	'Af-sE-G@
afzeiken	'Af-sE+-k@
agenda	a-'GEn-da
ah	'a
ah-	'a
aha	a-'ha
ahah	A-'hAh
ahahahah	A-hAh-A-'hAh
ahoy	a-'hOj
ahum	'A-hY
airconditioning	'E:r-k@n-dI-S@-nIN
aj	'aje
akeligs	'a-k@-l@xs
akkoorden	A-'kor-d@
al	'Al
al-	'Al
al-al	'A-lAl
albert	'Al-b@rt
album	'Al-bYm
alcoh	'Al-kO
alcohol	'Al-ko-hOl
alcoholvrij	Al-ko-hOl-'vrE+
alert	a-'lErt
alexander	A-l@k-'sAn-d@r
algehele	'Al-G@-he-l@
algemene	Al-G@-'me-n@
alhoewel	Al-hu-'wEl
ali	'A-li
alineaatje	a-'li-ni-ja-tj@
all	'Al
alle	'A-l@
allebei	A-l@-'bE+
alleen	A-'len
alleenstaand	A-'len-stant
allem-	'A-l@m
allemaal	A-l@-'mal
allemaal-allemaal	'A-l@-mal-A-l@-mal
allem-allemaal	'A-l@m-A-l@-mal
allen	'A-l@
allerlei	A-l@r-'lE+
allerslechtste	A-l@r-'slExt-st@
alles	'A-l@s
allez	'A-le
allicht	A-'lIxt
als	'Als
alsnog	Als-'nOx
also-	'Al-so
alsof	Als-'Of
alt	'Alt
alternatief	Al-t@r-na-'tif
althans	Al-'tAns
altijd	Al-'tE+t
alumnivereniging	'a-lYm-ni-v@-re-nI-GIN
alv	'a-El-ve
alvast	Al-'vAst
alweer	Al-'wer
am	'am
am-	'Am
ambacht	'Am-bAxt
amena	A-'me-na
amerika	a-'me-ri-ka
a-merken	'a-mEr-k@n
amro	'Am-ro
amsterdam	'Am-st@r-dAm
analyse	a-na-'li-z@
analyseren	a-na-li-'ze-r@
and	'Ant
ande-	'An-d@
ander	'An-d@r
anderdaad	'An-d@r-dat
andere	'An-d@-r@
anderen	'An-d@-r@
anderhalf	'An-d@r-hAlf
anderhalve	'An-d@r-hAl-v@
anders	'An-d@rs
andersom	'An-d@r-sOm
anderzijds	'An-d@r-zE+ts
angela	'A-N@-la
angst	'ANst
anna	'A-na
annastraa	'A-nA-strat
anne	'A-E:@
annemarie	A-E:e-ma-'ri
anno	'A-no
anouk	A-'n2k
anti	'An-ti
antwerpen	'Ant-wEr-p@
antwoord	'Ant-wort
antwoorden	'Ant-wor-d@
aoki-achtig	a-'o-ki-ax-t@x
aorta	a-'Or-ta
ap	'a-pe
ap-	'Ap
apart	a-'pArt
aparte	a-'pAr-t@
apen	'a-p@
app	'Ep
apparaat	A-pa-'rat
apparaatje	A-pa-'rat-j@
apparaatjes	A-pa-'rat-j@s
apparaten	A-pa-'ra-t@
apparatuur	A-pa-ra-'tyr
apple	'a-p@l
apps	'Eps
arabistiek	a-rA-bIs-'tik
arbeid	'Ar-bE+t
arbitrair	Ar-bi-'trE:r
archief	Ar-'xif
architectuurstijl	'ar-Si-tek-tyr-stE+l
arena	a-'re-na
arends	'a-r@nts
argo	'Ar-Go
argument	'Ar-Gy-mEnt
argwaan	'ArG-wan
ariÃ«n	ari@n
ariÃ«ns	ari@ns
ariën	'a-ri-@n
ariëns	'a-ri-@ns
aristoteles	'a-rIs-to-te-l@s
arjan	'ar-jAn
arjen	'Ar-j@
armen	'Ar-m@
arn-	'Arn
arnhem	'Ar-nEm
arnoud	'Ar-nA+t
arnouds	'Ar-nA+ds
artikel	Ar-'ti-k@l
artikelen	Ar-'ti-k@-l@
artikeltje	Ar-'ti-k@l-tj@
asa	'a-sa
asked	'askt
asociaal	a-so-'Sal
asociale	a-so-'Sa-l@
asserties	A-'sEr-tsIs
assertions	A-'s@r-sjYns
assignments	A-'sAjn-m@nts
assistenten	A-si-'stEn-t@
associatie	A-so-'Sa-tsi
aten	'a-t@
attaratuur	A-tA-ra-'tyr
au	'A+
au-	'A+
augustus	A+-'GYs-tYs
autistisch	A+-'tIs-tis
auto	'A+-to
autocue	'A+-to-kyw
automaten	A+-to-'ma-t@
automatisch	A+-to-'ma-tis
autorai	'A+-to-rAj
avans	'A-vAns
aversie	a-'vEr-zi
avond	'a-vOnt
avondje	'a-vOnt-j@
avonds	'a-vOnts
awkward	'aw-kwArd
ayla	'Aj-la
azië	'a-zi
aziatische	a-zi-'ja-ti-s@
aziÃ«	azi
b	'be
baan	'ban
baantje	'ban-tj@
baantjes	'ban-tj@s
baard	'bart
baas	'bas
babbe	bA-b@
babbelen	'bA-b@-l@
bachelor	'bA-S@-l@r
bachelor-uitreiking	'bAt-S@-l@r-Y+t-rE+-kIN
backgammon	bEg-'xA-mOn
bah	'bA
bahaviour	bE-'+v-jyr
bak	'bAk
bakel	'ba-k@l
bakken	'bA-k@
bakker	'bA-k@r
bakkertjes	'bA-k@r-tj@s
balans	ba-'lAns
balansding	bA-'lAns-dIN
balaton	'bA-lA-tOn
balen	'ba-l@
balken	'bAl-k@
balkje	'bAlk-j@
balkon	bAl-'kOn
balkonbak	bAl-'kOn-bAk
balletje	'bA-l@-tj@
bam	'bam
ban	'bAn
banaantjes	bA-'nan-tj@s
bananasplit	ba-'na-na-splIt
bananen	ba-'na-n@
bananenplant	bA-'na-n@n-plAnt
band	'bEnt
bandje	'bAnt-j@
bandjes	'bAnt-j@s
bands	'bEnts
banen	'ba-n@
bang	'bAN
bank	'bANk
banken	'bAN-k@
bar	'bAr
barbecue	'bAr-b@-kjuw
barbecueÃ«n	bArb@kjuw@n
barbecueën	'bAr-b@-kju-w@n
barbecuetje	'bAr-b@-kjuw-tj@
barbie	'bAr-bi
barokstijl-achtige	bA-'rOk-stE+l-Ax-t@-x@
barrels	'bE-r@ls
bart	'bArt
barts	'bArts
bas	'bAs
baseert	ba-'zert
basis	'ba-z@s
basisschoolniveau	'ba-sIs-sxol-nI-vo
basterd	'bAs-t@rt
bauer	'bA+-w@r
bavaria	ba-'va-ri-ja
b-beetje	b-'be-tj@
b-beide	b-'bE+-d@
b-bekende	b-b@-'kEn-d@
b-bepaalde	b-b@-'pal-d@
b-bijna	b-'bE+-na
bdo	'be-de-o
be	'b@
be-	'b@
beantwoorden	b@-'Ant-wor-d@
beargumenteerd	be-jAr-Gy-mEn-'tert
bebob	'bi-bOp
bed	'bEt
beda-	'bE-dA
bedacht	b@-'dAxt
bedankt	b@-'dANkt
bede	'be-d@
bede-	'b@-dE
bedenk	b@-'dENk
bedenkelijk	b@-'dEN-k@-l@k
bedenken	b@-'dEN-k@
bedoel	b@-'dul
bedoelde	b@-'dul-d@
bedoeling	b@-'du-lIN
bedoelt	b@-'dult
bedrag	b@-'drAx
bedrijf	b@-'drE+f
bedrijfskunde	b@-'drE+fs-kYn-d@
bedrijfswaarde	b@-'drE+fs-war-d@
bedrijven	b@-'drE+-v@
bedroevend	b@-'dru-v@nt
beeld	'belt
beelden	'bel-d@
beeldscherm	'belt-sxErm
beeldschoon	'belt-sxon
beelen	'be-l@n
beest	'best
beesten	'bes-t@
beet	'bet
beetje	'bet-j@
beetje-beetje	'be-tj@-be-tj@
beg-	'b@G
begin	b@-'GIn
beginnen	b@-'GI-n@
begint	b@-'GInt
begintijd	b@-'GIn-tE+t
begon	b@-'GOn
begonnen	b@-'GO-n@
begrafenis	b@-'Gra-f@-nIs
begreep	b@-'Grep
begrijp	b@-'GrE+p
begrijpen	b@-'GrE+-p@
beh	'be
beh-	'b@
behalen	b@-'ha-l@
behalve	b@-'hAl-v@
behang	b@-'hAN
beheerder	b@-'her-d@r
behoorlijk	b@-'hor-l@k
behoren	b@-'ho-r@
beide	'bE+-d@
beiden	'bE+-d@
bejaarden	b@-'jar-d@
bek	'bEk
bekend	b@-'kEnt
bekenden	b@-'kEn-d@
bekender	b@-'kEn-d@r
bekijken	b@-'kE+-k@
bekt	'bEkt
bekte	'bEk-t@
bel	'bEl
belachelijk	b@-'lA-x@-l@k
belanden	b@-'lAn-d@
belangrijk	b@-'lAN-rE+k
belangrijke	b@-'lAN-rE+-k@
belangrijker	b@-'lAN-rE+-k@r
belangrijks	b@-'lAN-rE+ks
belangrijkste	b@-'lAN-rE+k-st@
belangstelling	b@-'lAN-stE-lIN
belde	'bEl-d@
belgrado	'bEl-Gra-do
bellen	'bE-l@
belletje	'bE-l@-tj@
bemmel	'bE-m@l
ben	'bEn
benadeeld	b@-'na-delt
benaderen	b@-'na-d@-r@
benadrukt	b@-'na-drYkt
benauwd	b@-'nA+wt
beneden	b@-'ne-d@
benen	'be-n@
benie-	'b@-ni
benieuwd	b@-'niwt
bent	'bEnt
bepaald	b@-'palt
bepaald-	'b@-palt
bepaalde	b@-'pal-d@
bepakking	b@-'pA-kIN
bepalen	b@-'pa-l@
beperkt	b@-'pErkt
ber	'bEr
bereid	b@-'rE+t
bereik	b@-'rE+k
bereiken	b@-'rE+-k@
bereklauw	'be-r@-klA+w
überhaupt	y-b@r-'hA+pt
berichtje	b@-'rIxt-j@
berlijn	'bEr-lE+n
beroep	b@-'rup
beroepsorganisatie	b@-'rups-Or-Ga-ni-za-tsi
beroerd	b@-'rurt
bert	'bErt
bes	'bEs
bes-	'b@s
beschaafde	b@-'sxav-d@
beschikbaar	b@-'sxIg-bar
beschou-	b@-'sxA+
beschouw	b@-'sxA+w
beschrijft	b@-'sxrE+ft
beschrijving	b@-'sxrE+-vIN
besef	b@-'sEf
besloten	b@-'slo-t@
besluiten	b@-'slY+-t@
bespreken	b@-'spre-k@
besproken	b@-'spro-k@
best	'bEst
bestaan	b@-'stan
bestaansrecht	b@-'stans-rExt
bestaat	b@-'stat
bestand	b@-'stAnt
beste	'bEs-t@
besteden	b@-'ste-d@
bestek	b@-'stEk
besteld	b@-'stElt
bestellen	b@-'stE-l@
bestond	b@-'stOnt
bestu-	'b@-sty
besturen	b@-'sty-r@
bestuur	b@-'styr
bestuurs	b@-'styrs
bestuursfunctie	b@-'styrs-fYNk-si
bestuursjack	b@-'styrs-jEk
bestuursjassen	b@-'styrs-jA-s@n
bestuurskamer	b@-'styrs-ka-m@r
bestuursleden	b@-'styrs-le-d@
bestuurslid	b@-'styrs-lIt
bestuurspak	b@-'styrs-pAk
bestuursshirts	b@-'styrs-S2rts
betaal	b@-'tal
betaald	b@-'talt
betaalt	b@-'talt
betalen	b@-'ta-l@
betekenis	b@-'te-k@-nIs
beter	'be-t@r
betere	'be-t@-r@
beteren	'be-t@-r@
beton	b@-'tOn
betonblokken	b@-'tOm-blO-k@
betonboor	b@-'tOn-bor
betreft	b@-'trEft
beuk	'b2k
beurswaarde	'b2rs-war-d@
beurt	'b2rt
beurzen	'b2r-z@
bev-	'bEv
bevallen	b@-'vA-l@
bevalt	b@-'vAlt
beveiliging	b@-'vE+-l@-GIN
bevers	'be-v@rs
beverwijk	'be-v@r-wE+k
bevestigt	b@-'vEs-t@xt
bewaar	b@-'war
bewegen	b@-'we-G@
beweging	b@-'we-GIN
bewegingen	b@-'we-GI-N@
bewindspersoon	b@-'wInts-p@r-son
bewust	b@-'wYst
bezet	b@-'zEt
bezetting	b@-'zE-tIN
bezig	'be-z@x
bezigheid	'be-z@x-hE+t
bezinning	b@-'zI-nIN
bezuinig	b@-'zY+-nIG
bezwaar	b@-'zwar
bezwaren	b@-'zwa-r@
b-heeft	b-'heft
bibliotheek	bi-bli-jo-'tek
bibliotheken	bi-bli-jo-'te-k@
bieb	'bip
biebpas	'bi-pAs
bier	'bir
bierbrouwerij	bir-brA+-w@-'rE+
biertje	'bir-tj@
biertjes	'bir-tj@s
bietsen	'bit-s@
big	'bIx
bij	'bE+
bijbel	'bE+-b@l
bij-bij	'bE+-bE+
bijgeleend	bE+-G@-lent
bijgepraat	'bE+-G@-prat
bijl	'bE+l
bijl-	'bE+l
bijlenen	'bE+-le-n@n
bijna	'bE+-na
bijsterhuizen	'bE+s-t@r-hY+-z@
bijten	'bE+-t@
bijv-	'bE+v
bijvoorb-	'bE+-vor-b
bijvoorbeeld	bE+-'vor-belt
bijwerken	'bE+-wEr-k@
bijzonder	bi-'zOn-d@r
billetjes	'bI-l@-tj@s
binnen	'bI-n@
binnenhof	'bI-n@-hOf
binnenkort	bI-n@-'kOrt
binnenstad	'bI-n@-stAt
biologen	bi-jo-'lo-G@
biologie	bi-jo-lo-'Gi
bioscoop	bi-jO-'skop
bioskooplijn	bi-Os-'kop-lE+n
bitches	'bI-tS@s
bitter	'bI-t@r
bitterballen	'bI-t@r-bA-l@
bizar	bi-'zAr
bl-	'bl
blaadjes	'blat-j@s
blaaskaak	'blas-kak
blablabla	'bla-bla-bla
blablablabla	'bla-bla-bla-bla
bladeren	'bla-d@-r@
blauwe	'blA+-w@
blblbl	'bl-bl-bl
bleef	'blef
bleek	'blek
blessures	'blE-s@-r@s
bleven	'ble-v@
blij	'blE+
blijf	'blE+f
blijft	'blE+ft
blijkbaar	'blE+g-bar
blijven	'blE+-v@
blik	'blIk
blikjes	'blIk-j@s
blikken	'blI-k@
bliss	'blIs
bloed	'blut
bloes	'blus
bloesje	'blus-j@
blok	'blOk
blokhuis	'blOk-hY+s
blokkade	blO-'ka-d@
blokken	'blO-k@
-blokken	'blO-k@n
blonde	'blOn-d@
blote	'blo-t@
blowen	'blo-w@
bluh	'bl2h
bmw	be-Em-'we
bn	be-'En
bo	'bo
bo-	'bo
bob	'bOp
bocht	'bOxt
boeiend	'bu-j@nt
boek	'buk
boeken	'bu-k@
boekje	'buk-j@
boekt	'bukt
boete	'bu-t@
bof	'bOf
boksen	'bOk-s@
bolletje	'bO-l@-tj@
bomen	'bo-m@
bonus	'bo-nYs
boom	'bom
boor	'bor
boorden	'bor-d@
boorm	'borm
boos	'bos
boothuis	'bot-hY+s
borden	'bOr-d@
bordje	'bOrt-j@
boren	'bo-r@
borrel	'bO-r@l
borrelen	'bO-r@-l@
borrelkamer	'bO-r@l-ka-m@r
borrelruimte	'bOr-@l-rY+m-t@
borsato	bOr-'zA-to
borst	'bOrst
borstcrawl	'bOrst-krO:l
borstel	'bOr-st@l
bos	'bOs
bosch	'bOs
bosjes	'bOs-j@s
boterhammen	'bo-t@r-hA-m@
botste	'bOts-t@
bouw	'bA+w
bouwen	'bA+-w@
bouwt	'bA+wt
bouwvakkers	'bA+w-vA-k@rs
boven	'bo-v@
bovenaan	bo-v@-'an
bovendien	bo-v@-'din
bovenin	bo-v@-'In
bovenk-	'bo-v@n-k
bovenste	'bo-v@ns-t@
bowlen	'bo-l@
boy	'bOj
boycot	'bOj-kOt
br-	'br
brabanders	'bra-bAn-d@rs
brabants	'bra-bAnts
bra-brabanders	bra-'bra-bAn-d@rs
brand	'brAnt
branden	'brAn-d@
brandpunt	'brAnt-pYnt
breda	bre-'da
breed	'bret
breekt	'brekt
breezer	'brej-z@r
brengen	'brE-N@
brengt	'brENt
bres	'brEs
briefje	'brif-j@
bril	'brIl
brix	'brIks
broek	'bruk
broer	'brur
broers	'brurs
broertje	'brur-tj@
brommer	'brO-m@r
brood	'brot
brother	'bro-t@r
brutus	'bry-tYs
b-side	bi-'sAjd
bucket	'bY-k@t
bui	'bY+
buienradar	'bY+-@n-ra-dar
buis	'bY+s
buiten	'bY+-t@
buitenland	'bY+-t@-lAnt
buitenlandse	'bY+-t@-lAnt-s@
buitenwereld	'bY+-t@-we-r@lt
buizensysteem	'bY+-z@n-si-stem
bukken	'bY-k@
bull	'bYl
bullshit	'bul-SIt
bureau	by-'ro
bureaus	by-'ros
burger	'bYr-G@r
bus	'bYs
bush	'bYS
business	'bIs-nIs
bussen	'bY-s@
buurt	'byrt
buurtje	'byr-tj@
bv	'be-ve
bv-	'bv
b-volgens	b-'vOl-G@ns
bw	'be-we
bw-	'bw
bwij	'bwE+
ca	se-'a
ca-	'kA
cabin	'kA-bIn
cabine	ka-'bi-n@
cadeau	ka-'do
cadeaus	ka-'dos
cadeautje	ka-'do-tj@
cafÃ©	ka-'fe
cafeetje	ka-'fe-tj@
cafÃ©s	ka-'fes
cafetaria	ka-fe-'ta-ri-ja
calorieÃ«n	ka-lo-'ri-j@
calvin	'kAl-vIn
camping	'kEm-pIN
campingterreit	'kAm-pIN-tE-rE+t
campus	'kAm-pYs
canceling	'kAn-s@-lIN
cardio	'kAr-di-o
cardiodingen	'kAr-di-o-dI-N@n
carnaval	'kAr-na-vAl
carnavalsvakantie	'kAr-na-vals-vA-kAn-tsi
carrey	'kE-rI
casus	'ka-zYs
casussen	'ka-zY-s@
casus-specifiek	'ka-sYs-spe-si-fik
catalogus	kA-'ta-lo-GYs
catchier	kE-'tSi@r
catharijne	kA-ta-'rE+-n@
c-co-schappers	k-'ko-sxa-p@rs
cd	se-'de
cda	se-de-'a
cd's	se-'des
censuur	sEn-'syr
cent	'sEnt
centen	'sEn-t@
centraal	sEn-'tral
central	'sEn-trAl
centrale	sEn-'tra-l@
centrum	'sEn-trYm
cÃ©zanne	s@zAn@
ch-	'tS
chagrijnig	SA-'GrE+-n@x
chaos	'xa-Os
chapman	'tSEp-mEn
charisma	xa-'rIs-ma
charismatisch	xa-rIs-'ma-tis
chauffeur	So-'f2r
cheap	'ip
cheaper	'tSi-p@r
checken	'tSE-k@
chemie-pack	xe-'mi-pAk
chemisch	'xe-mis
chicky	'tSI-kI
chill	'tSIl
chille	'tSI-l@
chillen	'tSI-l@n
chiller	'tSI-l@r
chrissy	'kr@-si
christelijke	'krIs-t@-l@-k@
christian	'krIs-ti-jAn
chronologisch	xro-no-'lo-Gis
chroomlaag	'Grom-laG
cht	se-ha-'te
-cht	'xt
cijfer	'sE+-f@r
circuit	sIr-'kwi
cirkeltje	'sIr-k@l-tj@
citroen	si-'trun
civil	si-'vIl
clichÃ©matig	kliSemat@x
clichématig	kli-Se-'ma-t@x
club	'klYp
co	'ko
co-	'ko
co-auteur	'ko-A+-t2r
cock	'kOk
coco	'ko-ko
coen	'kun
colbert	kOl-'bE~r
colbertje	kOl-'bE:r-j@
college	kO-'le-Z@
collegegeldkrediet	kO-'le-S@-GEld-kr@-dit
colleges	kO-'le-Z@s
collegezaal	kO-'le-Z@-zal
comedy	'kO-m@-di
comments	'kO-m@nts
commissaris	kO-mI-'sa-r@s
commissie	kO-'mI-si
commissies	kO-'mI-sis
communicatie	kO-my-ni-'kat-si
communicatieblokjes	kO-my-ni-'kA-tsi-blOk-j@s
communicatieprofiel	kO-my-ni-'kA-tsi-prO-fil
communicatievaardig-	kO-my-ni-'kA-tsi-var-d@x
communicatiewetenschappen	kO-my-ni-'ka-tsi-we-t@-sxA-p@
communisme	kO-my-'nIs-m@
communisten	kO-my-'nIs-t@
competitie	kOm-p@-'ti-tsi
compleet	kOm-'plet
completeness	kOm-'plit-n@s
complexere	kOm-'plEk-s@-r@
compliment	kOm-pli-'mEnt
comporoeien	'kOm-po-ru-j@n
comporoeiers	'kOm-po-ru-j@rs
comporoeit	'kOm-po-rujt
compo's	'kOm-pos
computer	kOm-'pju-t@r
con	'kOn
con-	'kOn
concentratie	kOn-sEn-'tra-tsi
concept	kOn-'sEpt
concert	kOn-'sErt
concurrent	kON-ky-'rEnt
condoom	kOn-'dom
condooms	kOn-'doms
conferentie	kOn-f@-'rEn-si
conferenties	kOn-f@-'rEn-sis
conflict	kOn-'flIkt
congres	kON-'GrEs
connecties	kO-'nEk-sis
consequente	kOn-s@-'kwEn-t@
consequentialisme	'kOn-sE-kwEn-tsia-lIs-m@
consequenties	kOn-s@-'kwEn-sis
conspiraty	kOn-'spI-ra-ti
constant	kOn-'stAnt
constructie	kOn-'strYk-si
consultancy	kOn-'zYl-t@n-si
contact	kOn-'tAkt
contacten	kOn-'tAk-t@
context	'kOn-tEkst
contracten	kOn-'trAk-t@
contractje	kOn-'trAk-tj@
contributie	kOn-tri-'by-tsi
control	k@n-'trol
controle	kOn-'trO:-l@
controleer	kOn-tro-'ler
controleert	kOn-tro-'lert
controlegroep	kOn-'trO:-l@-Grup
controleren	kOn-tro-'le-r@
controller	kOn-'trO-l@r
cool	'kowl
coop	'kop
coÃ¶rdineer	ko-wOr-di-'ner
corina	ko-'ri-na
corine	ko-'ri-n@
correlaties	kO-r@-'la-tsis
correspent	kO-r@-'spEnt
correspondent	kO-r@-spOn-'dEnt
correspondent-dingen	kO-r@-spOn-'dEnt-dI-N@n
corton	kOr-'tO~
co-tolerant	'ko-tO-l@-rAnt
courant	ku-'rAnt
crashen	'krE-S@
creatief	kre-ja-'tif
creÃ«ert	kre-'jert
creepy	'kre-pi
creÃ«ren	kre-'je-r@
crimes	'krAjms
criminaliteit	kri-mi-na-li-'tE+t
criteria	kri-'te-ri-ja
cruise	'krus
cultheld	'kYlt-hElt
cultureel	kYl-ty-'rel
cultuur	kYl-'tyr
currysaus	'kY-ri-sA+s
cv	se-'ve
cézanne	s@-'zA-n@
d	de
d66	'de-zE-s@-zEs-t@x
da	'da
da-	'da
daan	'dan
daar	'dar
daarachter	dar-'Ax-t@r
daarbij	'dar-bE+
daarbinnen	dar-'bI-n@
daardoor	dar-'dor
daarentegen	dar-@n-'te-G@
daarheen	'dar-hen
daarmee	dar-'me
daarna	dar-'na
daarnaartoe	dar-nar-'tu
daarnaast	dar-'nast
daarom	'dar-Om
daaromheen	dar-Om-'hen
daaronder	dar-'On-d@r
daarop	dar-'Op
daarover	dar-'o-v@r
daaruit	dar-'Y+t
daarvan	dar-'vAn
daarvoor	dar-'vor
dacht	'dAxt
dachten	'dAx-t@
dada	'da-da
da-da-	'dA-dA
da-daan	da-'dan
da-dan	dA-'dAn
da-das	dA-'dAs
da-dat	dA-'dAt
da-dat-dat	dA-'dAt-dAt
dadelijk	'da-d@-l@k
dag	'dAx
dagblad	'dAG-blAt
dagboek	'dAG-buk
dagen	'da-G@
dagje	'dAx-j@
dahar	'da-har
da-je	'dA-j@
dak	'dAk
dakterras	'dAk-tE-rAs
damn	'dAm
dan	'dAn
dance	'dans@
dancing	'dEn-sIN
dan-dan	'dAn-dAn
daniÃ«l	dan@l
daniël	'da-n@l
dank	'dANk
dann	'dan
dan-n	'dAn-n
dansen	'dAn-s@
das	'dAs
das-	'dAs
dassen	'dA-s@
dat	'dAt
dat-	'dAt
data	'da-ta
data-analyse	'da-ta-A-na-li-s@
dat-dat	'dAt-dAt
date	'dat@
dat-t	'dAt-t
datum	'da-tYm
datumprikkers	'da-tYm-prI-k@rs
dave	'dav@
dd	'de-de
d-d	d-d
d-daar	d-'dar
d-daartussenin	d-dar-tY-s@n-'In
d-dacht	d-'dAxt
d-dan	d-'dAn
d-dat	d-'dAt
d-d-d-	d-d-d
d-d-d-d-	d-d-d-d
dde	de-'dee
d-de	d-'d@
d-die	d-'di
d-dit	d-'dIt
d-dus	d-'dYs
de	'd@
de-	'd@
deadline	'dEd-lAjn
deal	'dil
debat	d@-'bAt
debiel	d@-'bil
decadent	de-ka-'dEnt
december	de-'sEm-b@r
de-de	'd@-d@
de-december	de-de-'sEm-b@r
de-de-de-de-	'd@-d@-d@-d@
de-de-de-de-de-de-de-	'd@-d@-d@-d@-d@-d@-d@
de-deden	de-'de-d@n
deden	'de-d@
de-doen	de-'dun
dee	'de
dee-	'de
deed	'det
deel	'del
definiÃ«ren	de-fi-'nje-r@
degene	d@-'Ge-n@
degenen	d@-'Ge-n@
dekhengst	'dEk-hENst
delen	'de-l@
dement	de-'mEnt
dempen	'dEm-p@
den	'dEn
denk	'dENk
denken	'dEN-k@
-denking	'dEn-kIN
denkt	'dENkt
der	'dEr
derde	'dEr-d@
dergelijks	'dEr-G@lks
dermatologe	dEr-ma-to-'lo-G@
dertien	'dEr-tin
dertiende	'dEr-tin-d@
dertig	'dEr-t@x
descartes	dEs-'kAr-t@s
design	di-'zAjn
designer	de-'sAj-n@r
desnoods	dEs-'nots
deur	'd2r
deuren	'd2-r@
deurne	'd2r-n@
deze	'de-z@
dezelfde	d@-'zElv-d@
di	'di
di-	'di
dicht	'dIxt
dichtbij	dIGd-'bE+
dichterbij	dIx-t@r-'bE+
dichtgedaan	'dIxt-x@-dan
di-di-di-dit	'dI-dI-dI-dIt
die	'di
die-die	di-'di
die-die-die	di-di-'di
dienst	'dinst
diensten	'dins-t@
diep	'dip
diepe	'di-p@
dieper	'di-p@r
diepgewortelde	'dip-x@-wOr-t@l-d@
diepte	'dip-t@
dieren	'di-r@
diez-	'diz
dieze	'di-z@
digitale	di-Gi-'ta-l@
dijsselbloem	'dE+-s@l-blum
dik	'dIk
dikke	'dI-k@
dimensie	di-'mEn-zi
ding	'dIN
dingen	'dI-N@
dingetje	'dI-N@-tj@
dingetjes	'dI-N@-tj@s
dinosaurs	di-no-'sA+rs
dinsdag	'dInz-dAx
dinsdagavond	'dInz-dAG-a-vOnt
dinsdags	'dInz-dAxs
direct	di-'rEkt
dirk	'dIrk
discussie	dIs-'kY-si
disputen	dIs-'py-t@
dispuut	dIs-'pyt
dit	'dIt
dive-	'di-vE
diversiteit	di-vEr-si-'tE+t
dj	'de-je
dja	'tja
d-ja	d-'jA
djeez	'djes
djij	'djE+
djmag-uitslag	di-djEj-'mAg-Y+t-slAG
dj's	'de-jes
dna	de-En-'a
docent	do-'sEnt
dochter	'dOx-t@r
document	do-ky-'mEnt
documenten	do-ky-'mEn-t@
doe	'du
doedag	'du-dAG
doedelzakken	'du-d@l-zA-k@
doel	'dul
doem	'dum
doen	'dun
doet	'dut
dol	'dOl
doldwa-	'dOl-dwa
dolle	'dO-l@
dom	'dOm
domme	'dO-m@
donderdag	'dOn-d@r-dAx
donderdagavond	dOn-d@r-dax-'a-vOnt
done	'don@
dongens	'dO-N@ns
donkerblauw	'dON-k@r-blA+w
donkerblauwe	'dON-k@r-blA+-w@
donner	'dO-n@r
dood	'dot
dool-doolhof	dol-'dol-hOf
doolhof	'dol-hOf
door	'dor
doordat	dor-'dAt
doorgaan	'dor-Gan
doorgegeven	'dor-G@-Ge-v@
doorgelezen	'dor-G@-le-z@
doorgroeimogelijkheden	'dor-Gruj-mo-G@-l@k-he-d@
doorheen	dor-'hen
doorknallen	'dor-knA-l@n
doorlezen	dor-'le-z@
doorlopen	dor-'lo-p@
doorlopend	'dor-lo-p@nt
doornroosje	dorn-'ros-j@
dorp	'dOrp
dorpje	'dOrp-j@
dorpsoudste	'dOrps-uA+t-st@
dou	'dA+
dou-	'dA+
douchen	'du-S@
download	'dA+n-lowAt
dr	'dr
d'r	d@r
dr-	'dr
draad	'drat
draadjes	'drat-j@s
draagt	'draxt
draai	'draj
draai-	'draj
draaide	'draj-d@
draaien	'dra-j@
draait	'drajt
draak	'drak
dragen	'dra-G@
drama	'dra-ma
drang	'drAN
drank	'drANk
dranklevering	'drAnk-le-v@-rIN
dream	'drim
dreigt	'drE+xt
drie	'dri
drieÃ«n	drij@
drieÃ«ntwintig	'dri-jEn-twIn-t@x
driehonderd	'dri-hOn-d@rt
driehonderdvijftig	dri-hOn-d@rt-'vE+f-t@x
driehonderdzesenzestig	dri-hOn-d@rt-'zEs-@n-zEs-t@x
driekwart	'dri-kwArt
drieën	'dri-j@
drie-rie	dri-'ri
drik	'drIk
drink	'drINk
drinken	'drIN-k@
drinks	'drInks
drinkt	'drINkt
dürüm	'dY-rYm
droge	'dro-G@
drol	'drOl
dromen	'dro-m@
dronken	'drON-k@
droog	'drox
drrr	'dr
drugs	'drYks
drugsgebruik	'drYxs-x@-brY+k
druif	'drY+f
druk	'drYk
drukst	'drYkst
drukt	'drYkt
drukte	'drYk-t@
drummer	'drY-m@r
ds-	'ds
dubbel	'dY-b@l
dubbele	'dY-b@-l@
dubstep	'dYb-stEp
duh	'dY
duidelijk	'dY+-d@-l@k
duidelijker	'dY+-d@-l@-k@r
duits	'dY+ts
duitse	'dY+t-s@
duitser	'dY+t-s@r
duitsers	'dY+t-s@rs
duizend	'dY+-z@nt
dukenburg	'dy-k@m-bYrx
dum-	'dYm
dumbelltjes	'dYm-b@l-tj@s
duo	'dy-wo
dure	'dy-r@
duren	'dy-r@
durex	'dy-rEks
durf	'dYrf
durft	'dYrft
dÃŒrÃŒm	dYrYm
durven	'dYr-v@
dus	'dYs
dus-s	'dYs-s
duur	'dyr
duurde	'dyr-d@
duurt	'dyrt
duwen	'dy-w@
dvd	de-ve-'de
dwaze	'dwa-z@
dwerg	'dwErx
dwergen	'dwEr-G@
dz	'dz
dz-	'dz
dz-dz-	'dz-dz
e	'e
e-books	'e-buks
ech	'Ex
ech-	'Ex
ech-echt	Ex-'Ext
echt	'Ext
echte	'Ex-t@
echt-t	'Ext-t
economie	e-ko-no-'mi
edgar	'Ed-xAr
ee	'e
ee-	'e
e-echt	E-'Ext
eeg	e-e-'xe
een	'@n
e-en	E-'En
Ã©Ã©n	en
een-een	'en-en
Ã©Ã©n-Ã©Ã©n	enen
eenentwintig	'en-En-twIn-t@x
eenmaal	'en-mal
eens	'ens
eens-s	'ens
eentje	'en-tj@
eenzaam	'en-zam
eer	'er
eerder	'er-d@r
eergister	'er-GIs-t@r
eergisteren	er-'GIs-t@-r@
eerlijk	'er-l@k
eerst	'erst
eerste	'er-st@
eerstejaars	er-st@-'jars
eet	'et
eeuwe	'e-w@
ef-	'Ef
effe	'E-f@
effect	E-'fEkt
effecten	E-'fEk-t@
effectief	E-fEk-'tif
effects	E-'fEkts
effenaar	'E-f@-nar
effentjes	'E-f@n-tj@s
effetjes	'E-f@-tj@s
eg	e-'xe
-eg	'EG
eh	e-'ha
eh-	'2
Ãšh	E
ehm	'@m
ei	'E+
eigen	'E+-G@
eigen-	'E+-G@n
eigenlijk	'E+-G@-l@k
eiland	'E+-lAnt
eind	'E+nt
eind-	'E+nd
einde	'E+n-d@
eindelijk	'E+n-d@-l@k
eindhoven	'2Int-ho-v@
eindhovense	'2Int-ho-v@-s@
eindigt	'E+n-d@xt
eindredactie	'E+nd-re-dAk-si
eindresultaat	'E+nd-re-zYl-tat
elektriciteits-	e-lEk-trI-sI-'tE+t
elektrische	e-'lEk-tri-s@
elf	'Elf
elias	'e-li-jas
elisabeth	e-'li-za-bEt
elk	'Elk
elkaar	El-'kar
elkaars	El-'kars
elke	'El-k@
elk-elke	Elk-'El-k@
ellende	E-'lEn-d@
ellendig	E-'lEn-d@x
elsevier	'el-s@-vir
email	'e-mAjl
emmer	'E-m@r
en	'En
endomondo	En-dO-'mOn-dO
ene	'e-n@
enen	'e-n@
en-en	'En-En
en-en-en-en-en	'En-En-En-En-En
energie	e-nEr-'Zi
energy	'E-n@r-dji
enerzijds	'e-n@r-zE+ts
eng	'EN
engeland	'E-N@-lAnt
engels	'E-N@ls
engelse	'E-N@l-s@
engst	'ENst
enig	'e-n@x
enige	'e-n@-G@
enigste	'e-n@x-st@
enkel	'EN-k@l
enkele	'EN-k@-l@
en-n	'En-n
enorm	e-'nOrm
enorme	e-'nOr-m@
entree	En-'tre
epi	'e-pi
epi-	'E-pI
episod-	'E-pI-sod
er	'Er
er-	'Er
eraan	Er-'an
erachter	Er-'Ax-t@r
eraf	Er-'Af
erasmusgebouw	e-'rAs-mYs-G@-bA+
erb-	'Erb
erbij	Er-'bE+
erbuiten	Er-'bY+-t@
erdoor	Er-'dor
erdoorheen	Er-dor-'hen
erg	'Erx
erge	'Er-G@
ergens	'Er-G@ns
erger	'Er-G@r
ergeren	'Er-G@-r@
ergste	'Erx-st@
erheen	Er-'hen
eric	'e-rIk
erik	'e-rIk
erin	Er-'In
ermee	Er-'me
erna	Er-'na
ernaar	Er-'nar
ernaartoe	Er-nar-'tu
ernst	'Ernst
eromheen	Er-Om-'hen
eronder	Er-'On-d@r
erop	Er-'Op
erover	Er-'o-v@r
ertegen	Er-'te-G@
ertegenop	Er-te-G@-'Op
ertegenover	Er-te-G@-'o-v@r
ertussen	Er-'tY-s@
eruit	Er-'Y+t
eruitziet	Er-'Y+t-sit
ervan	Er-'vAn
ervaring	Er-'va-rIN
ervoor	Er-'vor
esclave	Es-'kla-v@
estheeth-	Es-'tet
esthetica	Es-'te-ti-ka
esv	e-Es-'ve
etcetera	Et-'se-t@-ra
eten	'e-t@
ethisch	'e-tis
eu	e-'u
euh	'2h
eur-	'2r
euro	'2-ro
europese	2-ro-'pe-s@
euros	'2-ros
ev-	'ev
even	'e-v@
evenement	e-v@-n@-'mEnt
even-even	'e-v@n-e-v@n
event	'i-vEnt
eventjes	'e-v@n-tj@s
eventstatus	'e-vEnt-sta-tYs
eventueel	e-v@n-ty-'wel
evenveel	'e-v@n-vel
everything	'E-v@-ri-tIng
evil	'e-vIl
existentialisme	Ek-si-stEn-Sa-'lIs-m@
existentialisten	ek-sIs-tEn-sIA-'lIs-t@n
experiment	Eks-pe-ri-'mEnt
experimenten	Eks-pe-ri-'mEn-t@
experimentjes	Eks-pe-ri-'mEnt-j@s
extern	Eks-'tErn
extra	'Eks-tra
extreem	Eks-'trem
ey	e-'waj
eye	'e-Aj
eye-	'Aj
eyechecker	'aj-tZE-k@r
eyecheckingsexperimentje	'aj-tZEk-INs-Eks-pe-ri-mEn-tj@
ey'er	E-'+Er
ezels	'e-z@ls
f	'Ef
f-	f
faalt	'falt
facebook	'fEs-buk
factor	'fAk-tOr
faculteit	fA-kYl-'tE+t
fair	'fE:r
familie	fa-'mi-li
familiedag	fa-'mi-li-dAx
fan	'fEn
fans	'fEns
fantasie	fAn-ta-'zi
fantastisch	fAn-'tAs-tis
fascinerend	fA-si-'ne-r@nt
fasen	'fa-z@
fatsoenlijk	fAt-'sun-l@k
febo	'fe-bo
februari	fe-bry-'wa-ri
feest	'fest
feesten	'fes-t@
feestje	'fest-j@
feit	'fE+t
feromonen	fe-ro-'mo-n@n
fest	'fest
festival	'fEs-ti-vAl
feuten	'f2-t@n
fiches	'fi-S@s
fiets	'fits
fietsen	'fit-s@
fietskoerierachtige	'fIts-ku-rir-Ax-t@-x@
fietst	'fitst
fif-	'fif
fifa	'fi-fa
fiftyfifty	'fIf-ti-fIf-ti
fight	'fAjt
figuur	fi-'Gyr
fijn	'fE+n
fijne	'fE+-n@
fijner	'fE+-n@r
fik	'fIk
fikkie	'fI-ki
film	'fIlm
filmen	'fIl-m@
filmpjes	'fIlm-pj@s
films	'fIlms
filosofie	fi-lo-so-'fi
filosofische	fi-lo-'so-fi-s@
filter	'fIl-t@r
filteren	'fIl-t@-r@
finale	fi-'na-l@
financiÃ«le	finAnSel@
financiële	fi-nAn-'Se-l@
fit	'fIt
fitheid	'fIt-hE+t
fitness	'fIt-n@s
fitnessen	'fIt-n@-s@
fixen	'fIk-s@
fj	'fj
flabbergasted	'flE-b@r-gEs-t@d
flat	'flEt
flatgebouw	'flEt-x@-bA+w
flauw	'flA+w
fles	'flEs
flesje	'flEs-j@
flesjes	'flEs-j@s
flessen	'flE-s@
flikker	'flI-k@r
flink	'flINk
fluisteren	'flY+s-t@-r@
fluisterend	'flY+s-t@-r@nt
focus	'fo-kYs
focussen	'fo-kY-s@
fok	'fOk
fokking	'fO-kIN
fondsen	'fOnt-s@
fons	'fOns
fontys	'fOn-tis
food	'fut
for	'fOr
format	'fOr-mAt
formele	fOr-'me-l@
formtuyn	'fOrm-tY+n
formulier	fOr-my-'lir
fort	'fOr
foto	'fo-to
fotootje	'fo-to-tj@
foto's	'fo-tos
fotospel	'fo-to-spEl
fout	'fA+t
foute	'fA+-t@
fouten	'fA+-t@
foutje	'fA+-tj@
fox	'fOks
fragmenten	frAG-'mEn-t@
frank	'frANk
frans	'frAns
franse	'frAn-s@
fred	'frEt
fries	'fris
friet	'frit
frietbakje	'frit-bAk-j@
frietpan	'frit-pAn
fris	'frIs
frisse	'frI-s@
frites	'frits
frituren	fri-'ty-r@
frustrerend	frYs-'tre-r@nt
fu	'fy
fu-	'fy
fuck	'fYk
fucked	'fYk@d
fucking	'fY-kIN
fuik	'fY+k
fullti-	'ful-tAj
fulltime	'ful-tAjm
functie	'fYNk-si
functiegroep	'fYnk-si-Grup
fusies	'fy-zis
fust	'fYst
fusten	'fYs-t@
futu-	'fY-tY
futurama	fY-tjE-'ra-ma
fysieke	fi-'si-k@
g	'xe
g-	'G
ga	'xa
ga-	'Ga
gaa-	'Ga
gaaf	'xaf
gaan	'xan
gaande	'xan-d@
gaar	'xar
gaat	'xat
gaf	'xAf
ga-ga	'Ga-Ga
gala	'xa-la
game	'xem@
game-	'gE-m@
gamen	'gE-m@n
gaming	'gE-mIN
gandalf	'xAn-dA-l@f
gang	'xAN
gang-app	'GAN-Ap
gang-facebook	'GAN-fEs-buk
ganggenoot	'xA-N@-not
ganggenote-	'GAN-G@-no-t@
gare	'xa-r@
gast	'xAst
gastcollege	'xAst-kO-le-Z@
gasten	'xAs-t@
gastje	'xAs-tj@
gat	'xAt
gaten	'xa-t@
gatver	'xAt-f@r
gatver-	'GAt-v@r
gatverdamme	'xAt-f@r-dA-m@
gauw	'xA+w
gave	'xa-v@
ge	'x@
geanalyseerd	x@-a-na-li-'zert
gearresteerd	x@-A-rEs-'tert
gebak	x@-'bAk
gebakken	x@-'bA-k@
gebaseerd	x@-ba-'zert
gebeld	x@-'bElt
gebeurd	x@-'b2rt
gebeurde	x@-'b2r-d@
gebeuren	x@-'b2-r@
gebeurt	x@-'b2rt
gebied	x@-'bit
geblesseerd	x@-blE-'sert
gebleven	x@-'ble-v@
geboekt	x@-'bukt
gebogen	x@-'bo-G@
geboortehuis	x@-'bor-t@-hY+s
geboren	x@-'bo-r@
gebouw	x@-'bA+w
gebouwd	x@-'bA+wt
gebouwen	x@-'bA+-w@
gebracht	x@-'brAxt
gebruik	x@-'brY+k
gebruiken	x@-'brY+-k@
gebruikt	x@-'brY+kt
gebruikte	x@-'brY+k-t@
gecanceld	x@-'kAn-s@lt
gechild	Ge-'tSIlt
geclaimd	x@-'klemt
gecontroleerd	x@-kOn-tro-'lert
geda-	G@-'da
gedaan	x@-'dan
gedacht	x@-'dAxt
gedachte	x@-'dAx-t@
gedachtes	x@-'dAx-t@s
gedag	x@-'dAx
gedech-	G@-'dEx
geding	x@-'dIN
gedoe	x@-'du
gedrag	x@-'drAx
gedrags-	G@-'drAGs
gedrang	x@-'drAN
gedronken	x@-'drON-k@
geduwd	x@-'dywt
gedwongen	x@-'dwO-N@
geef	'xef
geeft	'xeft
geen	'xen
geert	'xert
geest	'xest
geestig	'xes-t@x
gefeut	G@-'f2t
gefietst	x@-'fitst
gefixt	G@-'fIkst
gefrituurd	G@-fri-'tyrt
geg	'xEG
gegaan	x@-'Gan
gege-	'G@-Ge
ge-gedaan	G@-G@-'dan
gegeten	x@-'Ge-t@
gegeven	x@-'Ge-v@
gegooid	x@-'Gojt
geh-	'G@
gehaald	x@-'halt
gehad	x@-'hAt
gehaktballetjes	x@-'hAgd-bA-l@-tj@s
gehanteerd	x@-hAn-'tert
geheimen	x@-'hE+-m@
gehoest	x@-'hust
gehoeven	x@-'hu-v@
geholpen	x@-'hOl-p@
gehoord	x@-'hort
gehouden	x@-'hA+-d@
gehou-houwen	G@-hA+-'hA+-w@n
gehuwd	x@-'hywt
geinig	'xE+-n@x
gejat	x@-'jAt
gek	'xEk
gek-	'G@k
gekeken	x@-'ke-k@
gekend	x@-'kEnt
gekke	'xE-k@
geklets	x@-'klEts
gekleurd	x@-'kl2rt
gekocht	x@-'kOxt
gekomen	x@-'ko-m@
gekookt	x@-'kokt
gekozen	x@-'ko-z@
gekregen	x@-'kre-G@
gekund	x@-'kYnt
gel	'ZEl
gel-	'G@l
gelachen	x@-'lA-x@
gelaten	x@-'la-t@
geld	'xElt
gelderlander	'xEl-d@r-lAn-d@r
geldstromen	'xElt-stro-m@
gele	'xe-l@
gele-	'G@-le
geleden	x@-'le-d@
geleerd	x@-'lert
gelegd	x@-'lExt
gelegen	x@-'le-G@
gelegenheden	x@-'le-G@-he-d@
gelezen	x@-'le-z@
gelij-	'G@-lE+
gelijk	x@-'lE+k
gelo-	'G@-lo
geloof	x@-'lof
gelooft	x@-'loft
gelopen	x@-'lo-p@
gelost	x@-'lOst
geloven	x@-'lo-v@
gelovig	x@-'lo-v@x
gelovige	x@-'lo-v@-G@
gelredome	'xEl-re-dom@
gelui	x@-'lY+
gelui-	G@-'lY+
geluid	x@-'lY+t
geluidskaart	x@-'lY+ts-kart
geluidsman	x@-'lY+ts-mAn
geluk	x@-'lYk
gelukkig	x@-'lY-k@x
gelukt	x@-'lYkt
gelul	x@-'lYl
gemaakt	x@-'makt
gemaild	x@-'melt
gemakkelijk	x@-'mA-k@-l@k
gematst	x@-'mAtst
gember	'xEm-b@r
gemeente	x@-'men-t@
gemerkt	x@-'mErkt
gemert	'x@-m@rt
gemiddeld	x@-'mI-d@lt
gemiddelde	x@-'mI-d@l-d@
gemist	x@-'mIst
gemoeten	x@-'mu-t@
gemotiveerd	x@-mo-ti-'vert
geneeskunde	x@-'nes-kYn-d@
generale	xe-n@-'ra-l@
genetisch	x@-'ne-tis
genieten	x@-'ni-t@
genius	'xe-ni-jYs
genoeg	x@-'nux
genomen	x@-'no-m@
genuanceerder	x@-ny-wAn-'ser-d@r
georganiseerd	x@-Or-Ga-ni-'zert
georganiseerds	G@-Or-gA-ni-'serts
geori-	'G@-o-rI
georiÃ«nteerd	x@-o-ri-jEn-'tert
gepast	x@-'pAst
gepersonalis-	'G@-pEr-so-na-lIs
gepersonaliseerd	G@-pEr-so-na-li-'sert
geplaatst	x@-'platst
gepland	x@-'plEnt
gepraat	x@-'prat
gepresenteerd	x@-pr@-zEn-'tert
geprezen	x@-'pre-z@
gepubliceerd	x@-py-bli-'sert
ger	'x@r
ger-	'G@r
geraakt	x@-'rakt
gerandomiseerd	G@-'rAn-do-mi-sert
gerandomiseerde	G@-rAn-do-mi-'ser-d@
gereageerd	x@-re-ja-'Gert
gereden	x@-'re-d@
gereedschap	x@-'ret-sxAp
gereedschappen	x@-'ret-sxA-p@
geregeld	x@-'re-G@lt
gericht	x@-'rIxt
gerookt	x@-'rokt
geschiedenis	x@-'sxi-d@-nIs
geschreven	x@-'sxre-v@
geslaagd	x@-'slaxt
geslagen	x@-'sla-G@
geslapen	x@-'sla-p@
gesloopt	x@-'slopt
gesneden	x@-'sne-d@
gesolliciteerd	x@-sO-li-si-'tert
gespeeld	x@-'spelt
gesponsord	x@-'spOn-s@rt
gespoten	x@-'spo-t@
gesprek	x@-'sprEk
gesprekken	x@-'sprE-k@
gespreksonderwerp	x@-'sprEks-On-d@r-wErp
gesproken	x@-'spro-k@
gest-	'G@st
gestaan	x@-'stan
gesteld	x@-'stElt
gestemd	x@-'stEmt
gestempeld	x@-'stEm-p@lt
gestolen	x@-'sto-l@
gestopt	x@-'stOpt
gestroomlijnd	x@-'strom-lE+nt
gestructureerd	x@-strYk-ty-'rert
gestuurd	x@-'styrt
getal	x@-'tAl
getekend	x@-'te-k@nt
geteld	x@-'tElt
getennist	x@-'tE-n@st
getoond	x@-'tont
getrouwd	x@-'trA+wt
getting	'gE-tIN
geu-goedkoop	G2-Gut-'kop
geval	x@-'vAl
gevallen	x@-'vA-l@
geven	'xe-v@
geverfd	x@-'vErft
gevoel	x@-'vul
gevolgd	x@-'vOlxt
gevonden	x@-'vOn-d@
gevraagd	x@-'vraxt
gevreten	x@-'vre-t@
gew	xe-e-'we
gew-	'G@w
geweest	x@-'west
geweldig	x@-'wEl-d@x
gewend	x@-'wEnt
gewerkt	x@-'wErkt
geweten	x@-'we-t@
gewicht	x@-'wIxt
gewichten	x@-'wIx-t@
gewichtjes	x@-'wIx-j@s
gewild	x@-'wIlt
gewisseld	x@-'wI-s@lt
gewo-	'G@-wo
gewon	x@-'wOn
gewon-	'G@-wOn
gewone	x@-'wo-n@
gewonnen	x@-'wO-n@
gewoon	x@-'won
geworden	x@-'wOr-d@
gez-	'G@z
gezaagd	x@-'zaxt
gezamenlijke	x@-'za-m@-l@-k@
gezegd	x@-'zExt
gezeik	x@-'zE+k
gezellig	x@-'zE-l@x
gezellige	x@-'zE-l@-G@
gezelliger	x@-'zE-l@-G@r
gezelligheid	x@-'zE-l@x-hE+t
gezet	x@-'zEt
gezeten	x@-'ze-t@
gezicht	x@-'zIxt
gezichtsuitdrukking	x@-'zIxts-Y+-drY-kIN
gezien	x@-'zin
-gezien	'G@-zin
gezondheid	x@-'zOnt-hE+t
gezongen	x@-'zO-N@
g-gaat	G-'Gat
g-gebeurt	G-G@-'b2rt
g-gewoon	G-G@-'won
g-gezocht	G-G@-'zOxt
g-groningen	G-'Gro-nI-N@n
ghana	'ga-na
gi-	'Gi
giel	'xil
gigantische	xi-'GAn-ti-s@
gigrantische	GI-'GrAn-ti-sx@
giletje	'SI-lEt-j@
gin	'dZIn
gin-	'GIn
ging	'xIN
gingen	'xI-N@
gister	'xIs-t@r
gisteravond	xIs-t@r-'a-vOnt
gisteren	'xIs-t@-r@
gisterenmiddag	xIs-t@-r@-'mI-dAx
gitaar	xi-'tar
gitaardingetje	gi-'tar-dI-N@-tj@
g-kapot	G-kA-'pOt
gl-	'Gl
glazen	'xla-z@
glijdt	'xlE+t
go	'xo
go-	'Go
goal	'gol
gobarentaal	GO-'ba-r@n-tal
god	'xOt
goden	'xo-d@
godsnaam	'xOts-nam
godverdomme	xOt-f@r-'dO-m@
goe	Gu
goe-	Gu
goed	'xut
goede	'xu-d@
goedgelovig	xut-x@-'lo-v@x
goedkeuren	'xut-k2-r@
goedkoop	xut-'kop
goedkope	xut-'ko-p@
goedkoper	xut-'ko-p@r
goeds	'xuts
goeie	'xu-j@
goesbeekseweg	'gus-bek-s@-wEG
goffertpark	'xO-f@rt-pArk
goh	'xO
goh-	'Go
goldstrike	'golt-strAjk
gomorra	xO-'mO-ra
gooi	'xoj
gooien	'xo-j@
gordijn	xOr-'dE+n
gordijntjes	xOr-'dE+n-tj@s
governance	'xo-v@r-nAns@
gozer	'xo-z@r
gr	'xeEr
gr-	'Gr
gra-	'Gra
graafseweg	'xraf-s@-wEx
graag	'xrax
graden	'xra-d@
graffiti	grE-'fI-ti
grafisch	'xra-fis
grammatica's	GrA-'ma-ti-kas
grammetje	'xrA-m@-tj@
grap	'xrAp
grapje	'xrAp-j@
grappen	'xrA-p@
grappig	'xrA-p@x
gras	'grA
grasmaaiers	'grAs-ma-j@rs
gratis	'xra-t@s
grendel	'xrEn-d@l
grens	'xrEns
grenst	'xrEnst
grenzen	'xrEn-z@
grieken	'xri-k@
griekenland	'xri-k@-lAnt
griet	'xrit
grijs	'xrE+s
grip	'xrIp
groen	'xrun
groenlinks	xrun-'lINks
groente	'xrun-t@
groep	'xrup
groepen	'xru-p@
groepje	'xrup-j@
groepjes	'xrup-j@s
groepsapp	'Grups-Ap
groepslocatie	'Grups-lo-ka-tsi
groepsopdracht	'xrups-Ob-drAxt
groesbeek	'xruz-bek
groesbeekse	'Grus-bek-s@
groesbeekseweg	'xruz-bek-s@-wEx
groetjes	'xrut-j@s
groningen	'xro-nIN@
groot	'xrot
grootschalig	xrot-'sxa-l@x
grootste	'xrot-st@
grote	'xro-t@
groter	'xro-t@r
grotere	'xro-t@-r@
grr	'gr
gruwelijk	'xry-w@-l@k
guardian	'gAr-di-jAn
guess	'gEs
guesthouse	'gEst-hA+s
guus	'gys
g-verschillende	x-fEr-'sxI-l@n-d@
h	'ha
èh	'E
h-	'h
hè	'hE
ha	'ha
ha-	'ha
haal	'hal
haalbaar	'hal-bar
haalde	'hal-d@
haalt	'halt
haar	'har
haarlem	'har-lEm
haars	'hars
haast	'hast
had	'hAt
hadden	'hA-d@
hadden-hadden	'hA-d@n-hA-d@n
ha-haalde	ha-'hal-d@
ha-had	hA-'hAt
hak	'hAk
hakenkruisen	'ha-k@-krY+-s@
hakken	'hA-k@
halen	'ha-l@
half	'hAlf
halfuur	'hAlf-yr
-haling	'ha-lIN
hall	'hAl
hallo	hA-'lo
halve	'hAl-v@
halverweek	hAl-v@r-'wek
halverwege	hAl-v@r-'we-G@
ham	'hAm
ham-	'hAm
hamburger	'hAm-bYr-G@r
hamburgerketen	'hAm-bYr-G@r-k@-t@
han	'hAn
han-	'hAn
hand	'hAnt
handboek	'hAnd-buk
handdoek	'hAn-duk
handel	'hAn-d@l
handeling	'hAn-d@-lIN
handelt	'hAn-d@lt
handen	'hAn-d@
handig	'hAn-d@x
handige	'hAn-d@-G@
handiger	'hAn-d@-G@r
handjes	'hAnt-j@s
handschrift	'hAnt-sxrIft
handtekening	'hAn-te-k@-nIN
hangen	'hA-N@
hangt	'hANt
hanneke	'hA-n@-k@
hans	'hAns
hansje	'hAns-j@
hap	'hAp
happen	'hA-p@
hard	'hArt
harde	'hAr-d@
harder	'hAr-d@r
hardlopen	'hArd-lo-p@
hardy	'hAr-di
haren	'ha-r@
harmonie	hAr-mo-'ni
harris	'hA-ris
hart	'hArt
hartaa-	hAr-'ta
hartaanval	'hArt-an-vAl
hartaanvallen	'hArt-an-vA-l@
hartstikke	'hArt-stI-k@
hbo	ha-be-'o
he	'he
he-	'he
hÃ©	he
hÃš	hE
health	'h@ls
heat	'hit
heb	'hEp
heb-	'hEp
hebben	'hE-b@
hebt	'hEpt
hecht	'hExt
hedonisme	he-do-'nIs-m@
heef	'hef
heef-	'hef
heeft	'heft
heel	'hel
heelma	'hel-ma
heen	'hen
heer	'her
heerlijk	'her-l@k
heet	'het
heette	'he-t@
heftig	'hEf-t@x
heftige	'hEf-t@-G@
heidegger	'hE+-d@-G@r
heijendaal	'hE+-@n-dal
heijn	'hE+n
heijnbrood	'hE+jn-brot
heilig	'hE+-l@x
hein	'hE+n
heineken	'hE+-n@-k@
heino	'hE+-no
heis	'hE+s
hekel	'he-k@l
hel	'hEl
helaas	he-'las
helden	'hEl-d@
helder	'hEl-d@r
hele	'he-l@
heleb-	'he-l@b
helemaal	he-l@-'mal
helem-helemaal	he-l@m-he-l@-'mal
helft	'hElft
hell	'hEl
helm	'hElm
helm-	'hElm
helmond	'hEl-mOnt
hem	'hEm
hema	'he-ma
hemd	'hEmt
hemdje	'hEmt-j@
hemelsnaam	'he-m@ls-nam
henry	'hEn-ri
her	'hEr
her-	'hEr
herdenking	hEr-'dEN-kIN
herdenkingsdienst	hEr-'dEN-kINz-dinst
herder	'hEr-d@r
herfst	'hErfst
herfstvak-	'hErfst-vAk
herfstvakantie	'hErfst-fa-kAn-si
herhaald	hEr-'halt
herhaalt	hEr-'halt
herinner	hEr-'I-n@r
herinneren	hEr-'I-n@-r@
herintroduceren	'hEr-In-tro-dy-se-r@n
herken	hEr-'kEn
herkenbaars	hEr-'kEn-bars
herkend	hEr-'kEnt
herrie	'hE-ri
hersenen	'hEr-s@-n@
hersens	'hEr-s@ns
hessel	'hE-s@l
hessels	'hE-s@ls
het	'@t
hete	'he-t@
heten	'he-t@
het-t	'hEt-t
hetzelfde	hEt-'sElv-d@
heu	'h2
heumensoord	'hejY-m@s-ort
hev-	'hev
heyendaalseweg	'hij-@n-dal-s@-wEx
heyendael	'hE+-j@n-dal
hezelstraat	'he-z@l-strat
h-had	h-'hAt
h-half	h-'hAlf
h-hebben	h-'hE-b@n
h-heeft	h-'heft
h-het	h-'hEt
h-hij	h-'hE+
h-hoe	h-'hu
hie-	'hi
hield	'hilt
hielden	'hil-d@
hier	'hir
hierachter	hir-'Ax-t@r
hierbij	'hir-bE+
hiernaartoe	hir-nar-'tu
hiernaast	hir-'nast
hiervan	'hir-vAn
hiervoor	'hir-vor
hij	'hE+
hij-hij	'hE+-hE+
hilarisch	hi-'la-ris
hilversum	'hIl-v@r-sYm
hipster	'hIp-st@r
hl-	'hl
hm	'@m
hmh	'hm
hmhm	'hm
ho	'ho
hobbit	'hO-bIt
hobby	'hO-bi
hoe	'hu
hoe-	'hu
hoed	'hut
hoedje	'hut-j@
hoef	'huf
hoefde	'huv-d@
hoeft	'huft
hoe-hoe	'hu-hu
hoei	'huj
hoeiets	hu-'Its
hoek	'huk
hoekje	'huk-j@
hoe-oe	'hu-u
hoepa	'hu-pA
hoes	'hus
hoesten	'hus-t@
hoev-	'huv
hoeveel	hu-'vel
hoeveelste	hu-'vel-st@
hoeven	'hu-v@
hoewel	hu-'wEl
hoezo	hu-'zo
hoger	'ho-G@r
hogere	'ho-G@-r@
hogeschool	ho-G@-'sxol
hohoho	'hO-hO-hO
hoi	'hOj
hokje	'hOk-j@
hokken	'hO-k@
homerus	'hom-rYs
homo	'ho-mo
homo-erotische	ho-mo-E-'ro-ti-S@
honderd	'hOn-d@rt
hongarije	hON-GA-'rE+-j@
honger	'hO-N@r
hoofd	'hoft
hoofddoekjes	'hoft-duk-j@s
hoofden	'hov-d@
hoofdvak	'hoft-fAk
hoofdvakken	'hoft-fA-k@
hoog	'hox
hoogtepunt	'hox-t@-pYnt
hoogtepunten	'hox-t@-pYn-t@
hoop	'hop
hoopte	'hop-t@
hoor	'hor
hoorcollege	'hor-kO-le-Z@
hoorde	'hor-d@
hoort	'hort
hopelijk	'ho-p@-l@k
hopen	'ho-p@
horen	'ho-r@
horloge	hOr-'lo-Z@
hormoon	hOr-'mon
ho's	'hos
hostell	'hOs-t@l
hot	'hOt
hotel	ho-'tEl
hotels	ho-'tEls
hou	'hA+
houd	'hA+t
houden	'hA+-d@
houding	'hA+-dIN
houdt	'hA+t
hou-houden	hA+-'hA+-d@n
houwen	'hA+-w@
huh	'hY
huhuh	Ah-'Ah
huid	'hY+t
huidi-	'hY+-dI
huil	'hY+l
huilen	'hY+-l@
huilend	'hY+-l@nt
huis	'hY+s
huisfeest	'hY+s-fest
huisgenoot	'hY+s-x@-not
huisgenoten	'hY+s-x@-no-t@
huisje	'hY+s-j@
huisjes	'hY+S-@s
huisschilder	'hY+-sxIl-d@r
huisvesting	'hY+s-fEs-tIN
huiswerk	'hY+s-wErk
huize	'hY+-z@
hun	'hYn
hup	'hYp
huur	'hyr
huurcontract	'hyr-kOn-trAkt
huurde	'hyr-d@
huys	'hYes
hypothese	hi-po-'te-z@
hypothetisch	hi-po-'te-tis
i	'i
-i	'I
i-	'i
ic	i-'se
id	i-'de
id-	'Id
ideaal	i-de-'jal
ideale	i-de-'ja-l@
idealen	i-de-'ja-l@
idealistisch	i-de-ja-'lIs-tis
idee	i-'de
idyllisch	i-'dI-lis
ie	'i
ie-	'i
iede	'ie-d@
iede-	'i-d@
ieder	'i-d@r
ieder-	'i-d@r
iedere	'i-d@-r@
iedereen	'i-d@r-en
iejeneeie	'i-j@-ne-j@
iemand	'i-mAnt
iemands	'i-mAnts
iets	'its
ietsje	'its-j@
i-i-	'I-I
i-identiteit	I-'I-dEn-tI-tE+t
i-iets	i-'its
i-ik	I-'Ik
i-im-i-ik	I-Im-I-'Ik
i-in	I-'In
i-inactief	I-In-Ak-'tif
ik	'Ik
ikea	i-'k@-a
ik-i	'Ik-I
ik-ik	'Ik-Ik
ik-ik-ik	'Ik-Ik-Ik
ik-k	'Ik-k
ikke	'I-k@
illustratief	I-ly-stra-'tif
ilse	'il-s@
i'm	'im
imaginationland	I-mA-gI-'nA-SIon-lAnd
immoreel	I-mo-'rel
immorele	I-mo-'re-l@
in	'In
incidentele	In-si-dEn-'te-l@
inclusief	IN-kly-'zif
indaad	In-'dad
inderd-	'In-d@r-d
inderda-	'In-d@r-da
inderdaad	In-d@r-'dat
indiase	'In-di-ja-s@
indruk	'In-drYk
ineens	In-'ens
infectie	In-'fEk-si
informa-	'In-fOr-ma
informatie	In-fOr-'ma-tsi
information	In-fOr-'ma-tSOn
informelere	In-fOr-'me-l@-r@
ingang	'IN-GAN
ingangseisen	'In-GANs-E+-s@n
ingehouden	'IN-G@-hA+-d@
ingenomen	'IN-G@-no-m@
ingepakt	'IN-G@-pAkt
ingepland	'IN-G@-plEnt
ingeschoten	'IN-G@-sxo-t@
ingeschr-	'In-G@-sxr
ingeschreven	'IN-G@-sxre-v@
ingevuld	'IN-G@-vYlt
ingezet	'IN-G@-zEt
inhoud	'In-hA+t
inhoudelijke	In-'hA+-d@-l@-k@
inhoudt	'In-hA+t
in-in	'In-In
in-in-in	'In-In-In
inkomen	'IN-ko-m@
inkorten	'IN-kOr-t@
inla-	'In-la
inleveren	'In-le-v@-r@
inloopt	'In-lopt
inluiden	'In-lY+-d@
innemen	'I-ne-m@
inpikken	'Im-pI-k@
inquisitie	IN-kwi-'si-tsi
inrationeel	'In-rA-tsio-nel
inrichting	'In-rIx-tIN
inschrijven	'In-sxrE+-v@
insigne	In-'sI-J@
insignes	In-'sI-J@s
inspiratieloosheid	In-spi-ra-tsi-'los-hE+t
inspreken	'In-spre-k@
installeren	In-stA-'le-r@
insteek	'In-stek
instellen	'In-stE-l@
instituut	In-sti-'tyt
instromen	'In-stro-m@
instroom	'In-strom
insturen	'In-sty-r@
inte-	'In-t@
integraal	In-t@-'Gral
intellect	In-t@-'lEkt
intellectueel	In-t@-lEk-ty-'wel
interactieve	In-t@r-Ak-'ti-v@
interessant	In-t@-rE-'sAnt
interessants	In-t@-rE-'sAnts
interesseren	In-t@-rE-'se-r@
intern	In-'tErn
internal	In-'t@r-nAl
internationaal	In-t@r-nA-tSo-'nal
internationale	In-t@r-nA-tSo-'na-l@
interpre-	'In-t@r-pr@
interpreteert	In-t@r-pr@-'tert
interview	In-t@r-'vjuw
interviews	'In-t@r-vjuws
introductie	In-tro-'dYk-si
introweekend	'In-tro-i-kEnt
invaller	'In-vA-l@r
invloed	'In-vlut
invloedrijk	'In-vlud-rE+k
invoeren	'In-vu-r@
invoert	'In-vurt
invullen	'In-vY-l@
invulling	'In-vY-lIN
inwerken	'In-wEr-k@
inzetten	'In-zE-t@
inzien	'In-zin
irrationeels	I-rA-tsio-'nels
irritant	I-ri-'tAnt
irritante	I-ri-'tAn-t@
irriteren	I-ri-'te-r@
is	'Is
is-	'Is
isis	'Is-Is
is-is	'Is-Is
isolatiemateriaal	i-so-'la-tsi-ma-te-ri-jal
isoleren	i-so-'le-r@
-istich	'Is-tis
it	'i-t
italiaans	i-ta-li-'jans
italiaanse	i-ta-li-'jan-s@
italianen	i-ta-li-'ja-n@
ivan	'i-vAn
j	'j
j-	'j
ja	'ja
ja-	'ja
ja-a	'ja-a
ja-a-a	'ja-a-a
ja-ah	'ja-a
jaap	'jap
jaar	'jar
jaartje	'jar-tj@
jacobi	ja-'ko-bi
jammer	'jA-m@r
jan	'jAn
jan-	'jAn
janken	'jAN-k@
janne	'jA-n@
jansenstraat	'jAn-s@n-strat
januari	ja-ny-'wa-ri
jaren	'ja-r@
jarig	'ja-r@x
jas	'jAs
jasje	'jAs-j@
jasjes	'jAs-j@s
jasper	'jAs-p@r
jassen	'jA-s@
jatten	'jA-t@
jawel	ja-'wEl
jazz	'dZEs
jazzfestival	'dZEs-fEs-ti-vAl
jazzkenner	'djE:s-kE-n@r
je	'j@
jee	'je
je-j	'jE-j
je-ja	'jE-ja
je-je	'j@-j@
jelle	'jE-l@
jeremy	'j@-rE-mi
jeroen	j@-'run
jeroens	j@-'runs
jerre	'jE-r@
jetlag	'dZEt-lEk
jetske	'jEt-sk@
jeuk	'j2k
jezelf	j@-'zElf
jezus	'je-zYs
jezuskruis	'je-zYs-krY+s
jij	'jE+
jill	'jIl
jim	'jIm
jimmie	'djI-mi
j-ja	j-'ja
j-jan	j-'jAn
j-je	j-'j@
j-jere-	j-'je-r@
j-jij	j-'jE+
jo	'jo
jo-	'jo
job	'jOp
jobje	'jOb-j@
joden	'jo-d@
joe	'ju
joehoe	'ju-hu
joerie	'ju-ri
joew	'juw
joh	'jO
john	'j2n
jointje	'dZOjn-tj@
jones	'jo-n@s
jong	'jON
jonge	'jO-N@
jongen	'jO-N@
jongens	'jO-N@ns
jongetjes	'jO-N@-tj@s
jordi	'jOr-di
jorg	'jOrx
joris	'jO-r@s
jou	'jA+
jou-jouw	'jA+-jA+w
journaal	Zur-'nal
journalisme	Zur-nA-'lis-m@
journalist	Zur-na-'lIst
jouw	'jA+w
jouzelf	jA+-'zEl@f
jow	'jA+
ju	'jy
ju-	'jy
juist	'jY+st
jul	'jyl
jul-	'jYl
juli	'jy-li
julia	'jy-li-ja
julie	'jy-li
jullie	'jY-li
junior	'jy-ni-jOr
jurassic	Zy-'rA-sIk
jurriÃ«n	Zyri@
jurriën	'Zy-ri@
jury	'Zy-ri
justitie	jys-'ti-tsi
k	'ka
-k	'k
k-	'k
ka	'ka
ka-	'ka
kaal	'kal
kaart	'kart
kaarten	'kar-t@
kaartje	'kart-j@
kaartjes	'kart-j@s
kaas	'kas
kabel	'ka-b@l
kaboutertje	ka-'bA+-t@r-tj@
kak	'kAk
kakvriendin	'kAk-vrin-dIn
kale	'ka-l@
kalibratie	kA-li-'bra-tsi
kalibreren	kA-li-'bre-r@n
kallibratie	kA-li-'bra-tsi
kamer	'ka-m@r
kamerlid	'ka-m@r-lIt
kamerplanten	'ka-m@r-plAn-t@
kamers	'ka-m@rs
kamertje	'ka-m@r-tj@
kamertjes	'ka-m@r-tj@s
kan	'kAn
kan-	'kAn
kannetje	'kA-n@-tj@
kans	'kAns
kant	'kAnt
kanten	'kAn-t@
kantiaans	kAn-ti-'ans
kantine	kAn-'ti-n@
kantines	kAn-'ti-n@s
kanton	kAn-'tOn
kantoor	kAn-'tor
kantoorbaan	kAn-'tor-ban
kantoren	kAn-'to-r@
kapot	ka-'pOt
kappen	'kA-p@
kapper	'kA-p@r
kapsalon	'kAp-sa-lOn
kapsalonnetje	'kAp-sa-lO-n@-tj@
karakterverandering	kA-'rAk-t@r-v@r-An-d@-riN
karig	'ka-r@x
kas	'kAs
kasper	'kAs-p@r
kast	'kAst
kasteeltje	kAs-'tel-tj@
kasten	'kAs-t@
kat	'kAt
katelijn	ka-t@-'lE+n
kater	'ka-t@r
katern	ka-'tErn
katholiek	kA-to-'lik
ke	ke
ke-	kE
keek	'kek
keer	'ker
keertje	'ker-tj@
kei	'kE+
keigezellig	'kE+-G@-zE-l@x
keihard	'kE+-hArt
keilen	'kE+-l@
keileuk	'kE+-l2k
keken	'ke-k@
ken	'kEn
kenden	'kEn-d@
kennelijk	'kE-n@-l@k
kennen	'kE-n@
kennis	'kE-n@s
kent	'kEnt
kerel	'ke-r@l
keren	'ke-r@
kerk	'kErk
kerken	'kEr-k@
kermisgeloof	'kEr-mIs-Ge-lof
kerst	'kErst
kerstmis	'kErst-mIs
kerstvakantie	'kErst-fa-kAn-si
kerven	'kEr-v@
keuken	'k2-k@
keuze	'k2-z@
keuzes	'k2-z@s
ki-	'kI
kickstarter	'kIk-stAr-t@r
kids	'kIts
kielzog	'kil-zOx
kiezen	'ki-z@
kijk	'kE+k
kijken	'kE+-k@
kijkt	'kE+kt
kill	'kIl
kilo	'ki-lo
kilometer	'ki-lo-me-t@r
kinderachtig	'kIn-d@r-Ax-t@x
kinderen	'kIn-d@-r@
kinderfilm	'kIn-d@r-fIlm
kip	'kIp
kistje	'kIst-j@
kitsch	'kitS
kitsch-kruizen	'kitS-krY+-z@n
k-kan	k-'kAn
kl	'kaEl
kl-	'kl
klaar	'klar
klagen	'kla-G@
klank	'klANk
klanten	'klAn-t@
klantenpakket	'klAn-t@n-pA-kEt
klap	'klAp
klapjes	'klAp-j@s
klappen	'klA-p@
klas	'klAs
klassieke	klA-'si-k@
kleding	'kle-dIN
klein	'klE+n
kleine	'klE+-n@
kleintje	'klE+n-tj@
kleren	'kle-r@
kleur	'kl2r
kleuren	'kl2-r@
kleurtjes	'kl2r-tj@s
klikken	'klI-k@
klikt	'klIkt
klimhal	'klIm-hal
klinkende	'klIN-k@n-d@
klinkt	'klINkt
klok	'klOk
klonk	'klONk
klool	'klol
klopboor	'klO-bor
klopt	'klOpt
klote	'klo-t@
kluis	'klY+s
klussen	'klY-s@
kn-	'kn
knalde	'knAl-d@
knalgele	'knAl-Ge-l@
knallen	'knA-l@
knalmuziek	'knAl-my-zik
knap	'knAp
knap-	'knAp
knapperige	'knA-p@-r@-G@
knettergek	'knE-t@r-GEk
knew	'niw
knie	'kni
knieÃ«n	knij@
knieën	'kni-j@
knollentuin	'knO-l@-tY+n
knollentuinstraat	'knO-l@n-tY+n-strat
knorren	'knO-r@
ko	'ko
ko-	'kO
kockelmann	'kO-k@l-mAn
koekje	'kuk-j@
koeling	'ku-lIN
koelkast	'kul-kAst
koepel	'ku-p@l
koffer	'kO-f@r
koffie	'kO-fi
kogel	'ko-G@l
koken	'ko-k@
kom	'kOm
komen	'ko-m@
komende	'ko-m@n-d@
komkommersalade	kOm-'kO-m@r-sa-la-d@
kommetjesset	'kO-m@-tj@-sEt
komt	'kOmt
kon	'kOn
konden	'kOn-d@
konijn	ko-'nE+n
koning	'ko-nIN
koninginnedag	ko-nI-'NI-n@-dAx
kont	'kOnt
kook	'kok
kookboek	'kog-buk
kookspullen	'kok-spY-l@n
koom-	'kom
koop	'kop
kop	'kOp
kopen	'ko-p@
kopje	'kOp-j@
kopjes	'kOp-j@s
koppijn	'kO-pE+n
koran	ko-'ran
kort	'kOrt
korte	'kOr-t@
kortere	'kOr-t@-r@
kos	'kOs
kos-	'kOs
kost	'kOst
kosten	'kOs-t@
koud	'kA+t
kozen	'ko-z@
kpmg	ka-pe-Em-'xe
kr-	'kr
krabben	'krA-b@
kracht	'krAxt
kramer	'kra-m@r
krant	'krAnt
kranten	'krAn-t@
krantenfonds	'krAn-t@n-fOnds
krantje	'krAnt-j@
krantjes	'krAnt-j@s
krap	'krAp
krat	'krAt
kreeg	'krex
kregen	'kre-G@
krij-	'krE+
krijg	'krE+x
krijgen	'krE+-G@
krijgt	'krE+xt
kringloop	'krIN-lop
kritiek	kri-'tik
kritisch	'kri-tis
kritische	'kri-ti-s@
kroeg	'krux
kroegentocht	'kru-G@-tOxt
krokusvakantie	'kro-kYs-fa-kAn-si
krone	'kro-n@
kronkel	'krON-k@l
kronkels	'krON-k@ls
kruiden	'krY+-d@
kruis	'krY+s
kruiswoordpuzzeltjes	'krY+s-wort-pY-s@l-tj@s
krul	'krYl
krullen	'krY-l@
krullenkop	'krY-l@n-kOp
ku	'ky
ku-	'ky
kuil	'kY+l
kuku	ky-'ky
ku-kun	kY-'kYn
kun	'kYn
kunnen	'kY-n@
kunst	'kYnst
kunsten	'kYns-t@
kunstgeschiedenis	'kYnst-x@-sxi-d@-nIs
kunstwerk	'kYnst-wErk
kunt	'kYnt
kussen	'kY-s@
kut	'kYt
kutgesprek	'kYt-G@sprEk
kutje	'kYt-j@
kutnummers	'kYt-nY-m@rs
kutte	'kY-t@
kutten	'kY-t@
kutweer	'kYt-wer
kutwerk	'kYt-wErk
kutwijf	'kYt-wE+f
kw	'ka-we
kw-	'kw
kwalificatie	kwa-li-fi-'ka-tsi
kwalijk	'kwa-l@k
kwaliteit	kwa-li-'tE+t
kwam	'kwAm
kwamen	'kwa-m@
kwart	'kwArt
kwartier	kwAr-'tir
kweken	'kwe-k@
kwijt	'kwE+t
l	'l
l-	'l
la	'la
laat	'lat
laatje	'la-tj@
laatst	'latst
laatste	'lat-st@
lach	'lAx
lachen	'lA-x@
ladderzat	'lA-d@r-zAt
lag	'lAx
lagen	'la-G@
lak	'lAk
lampen	'lAm-p@
lampje	'lAmp-j@
lampjes	'lAmp-j@s
land	'lAnt
landschap	'lAnt-sxAp
lang	'lAN
lange	'lA-N@
langer	'lA-N@r
langere	'lA-N@-r@
langs	'lANs
langskomen	'lANs-ko-m@
langstraat	'lAN-strat
langzaam	'lAN-zam
laptop	'lAp-tOp
laptopje	'lEp-tOp-j@
las	'lAs
lassen	'lA-s@
last	'lAst
lastig	'lAs-t@x
laten	'la-t@
laten-laten	'la-t@n-la-t@n
later	'la-t@r
latex	'la-tEks
laura	'lA+-ra
lauw	'lA+w
law	'lAO:
le	'l@
le-	'le
leden	'le-d@
ledenjasje	'le-d@n-jAs-j@
ledenjasjes	'le-d@n-jAs-j@s
leef	'lef
leeft	'left
leeftijd	'lef-tE+t
leeftijden	'lef-tE+-d@
leeg	'lex
leeghalen	'lex-ha-l@
leegmaken	'leG-ma-k@
leek	'lek
leem	'lem
leen	'len
leent	'lent
leer	'ler
leerme-	'ler-me
lees	'les
leest	'lest
leeuw	'lew
leeuwarden	le-'Ar-d@
leg	'lEx
legaal	le-'Gal
leger	'le-G@r
legerbasis	'le-G@r-ba-sIs
legereenheid	'le-g@r-en-hE+t
leggen	'lE-G@
leiden	'lE+-d@
lekker	'lE-k@r
lekkerder	'lE-k@r-d@r
lekkere	'lE-k@-r@
lelijk	'le-l@k
lemon	'l@-mOn
lenen	'le-n@
lening	'le-nIN
lennart	'lE-nArt
leonie	'le-jo-ni
leraar	'le-rar
leraren	'le-ra-r@
leren	'le-r@
les	'lEs
lessen	'lE-s@
let	'lEt
letten	'lE-t@
letteren	'lE-t@-r@
letters	'lE-t@rs
leu	'l2
leu-	'l2
leuk	'l2k
leuke	'l2-k@
leuker	'l2-k@r
leukere	'l2-k@-r@
leuks	'l2ks
leukst	'l2kst
leukste	'l2k-st@
leunt	'l2nt
leven	'le-v@
levensverzekeringswiskunde	'le-v@ns-v@r-ze-k@-rINs-wIs-kYn-d@
leveren	'le-v@-r@
levering	'le-v@-rIN
levert	'le-v@rt
lezen	'le-z@
lezingen	'le-zI-N@
lichaam	'lI-xam
lichamelijk	lI-'xa-m@-l@k
licht	'lIxt
lichten	'lIx-t@
lichting	'lIx-tIN
lid	'lIt
lief	'lif
liefst	'lifst
liep	'lip
liet	'lit
lieten	'li-t@
liever	'li-v@r
lig	'lIx
liggen	'lI-G@
ligt	'lIxt
lij-	'lE+
lijken	'lE+-k@
lijkt	'lE+kt
lijn	'lE+n
lijp	'lE+p
lijpe	'lE+-p@
lijst	'lE+st
lijstje	'lE+st-j@
li-ligt	lI-'lIGt
limburger	'lIm-bYr-G@r
limburgs	'lIm-bYrs
linken	'lIN-k@
links	'lINks
literatuur	li-t@-ra-'tyr
liters	'li-t@rs
live	'lAjf
living	'lI-vIN
l-leuk	l-'l2k
l-ligt	l-'lIGt
lo	'lo
lo-	'lo
locatie	lo-'ka-tsi
loek	'luk
loes	'lus
logisch	'lo-Gis
logistiek	lo-GIs-'tik
logo	'lo-Go
lol	'lOl
lomp	'lOmp
londen	'lOn-d@
longreads	'lON-reds
loon	'lon
loop	'lop
loopbanden	'lop-bAn-d@n
loopt	'lopt
loos	'los
lopen	'lo-p@
lord	'lOrt
los	'lOs
losjes	'lOs-j@s
losse	'lO-s@
lot	'lOt
lowlands	'lo-lAnts
lsd	El-Es-'de
lsd-trip	El-Es-'de-trIp
lucas	'lju-kas
lucht	'lYxt
lucky	'lY-ki
lugubere	ly-'Gy-b@-r@
lui	'lY+
luiheid	'lY+-hE+t
luister	'lY+s-t@r
luisteren	'lY+s-t@-r@
lukie	'lY-ki
lukken	'lY-k@
lukt	'lYkt
lulhannes	'lYl-hA-n@s
lullen	'lY-l@
lullig	'lY-l@x
lunchen	'lYn-S@
lustrum	'lYs-trYm
lustrumbestuur	'lYs-trYm-b@-styr
lustrumcommissie	'lYs-trYm-kO-mI-si
lutz	'lYts
luxor	'lyk-sOr
luyendijk	'ly-j@-dE+k
lyotard	'ljo-tArt
m	'Em
m-	'm
ma	'ma
ma-	'ma
maa-	'ma
maag	'max
maaglijk	'maG-lE+k
maai	'maj
maai-	'maj
maaike	'maj-k@
maak	'mak
maakt	'makt
maakte	'mak-t@
maakten	'mak-t@
maa-maar	ma-'mar
maand	'mant
maandag	'man-dAx
maandagavond	man-dAx-'a-vOnt
maanden	'man-d@
maar	'mar
maar-maar-maar-maar	'mar-mar-mar-mar
maart	'mart
maat	'mat
mac	'mAk
macbookje	'mEk-buk-j@
machine	mA-'Si-n@
machines	mA-'Si-n@s
machtsspel	'mAxt-spEl
mad	'mAt
madame	ma-'dAm
mafkezen	'mAf-ke-z@n
mag	'mAx
magazijn	mA-Ga-'zE+n
mail	'mel
mailtje	'mel-tj@
maken	'ma-k@
makkelijk	'mA-k@-l@k
makkelijke	'mA-k@-l@-k@
makkelijker	'mA-k@-l@-k@r
maliepaard	'ma-li-pard
malle	'mA-l@
mam	'mAm
mama	mA-'ma
ma-ma-maar	ma-ma-'mar
man	'mAn
management	'mE-n@dZ-m@nt
managementwetenschappen	'mE-n@S-mEnt-we-t@n-sxA-p@n
manager	'mE-n@-dZ@r
mandela	mAn-'de-la
mandje	'mAnt-j@
manie	ma-'ni
ma-nie-	'ma-ni
manier	ma-'nir
mannen	'mA-n@
mannetje	'mA-n@-tj@
manon	mA-'nOn
mappen	'mA-p@
marcheren	mAr-'Se-r@
marciano	mAr-sI-'a-no
marco	'mar-so
marian	ma-ri-'j@n
mark	'mArk
marketing	'mAr-k@-tIN
markt	'mArkt
marloes	mar-'lus
marokkaans	ma-rO-'kans
marokkaanse	ma-rO-'kan-s@
mars	'mArs
marsen	'mAr-s@
marsmannetjes	'mArs-mA-n@-tj@s
martin	'mar-tIn
marx	'mAr
master	'mAs-t@r
masterclass	'mas-t@r-klas
masteropleiding	'mAs-t@r-op-lE+-dIN
masters	'mAs-t@rs
materiaal	ma-te-ri-'jal
materialisa-	'mA-te-ri-a-lI-sa
matthijs	mA-'tE+s
maurice	mA+-'ri-s@
max	'mAks
maximaal	mAk-si-'mal
mayonaise	mA-jo-'nE:-s@
me	'm@
me-	'm@
mechanisme	me-xa-'nIs-m@
medaille	me-'dA-j@
medailles	me-'dA-j@s
media	'me-di-ja
mediatrai-	'me-dI-a-trEj
mediatraining	'me-di-ja-tre-nIN
medicijnen	me-di-'sE+-n@
medisch	'me-dis
medische	'me-di-s@
mee	'me
mee-	'me
meedenken	'me-dEN-k@
meedoen	'me-dun
meedragen	'me-dra-G@
meegaat	'me-Gat
meegegeven	'me-G@-Ge-v@
meegekregen	'me-G@-kre-G@
meegemaakt	'me-G@-makt
meegenomen	'me-G@-no-m@
meeloopt	'me-lopt
meen	'men
meeneembarbecue	'me-nem-bAr-b@l-kjuw
meenemen	'me-ne-m@
meep-	'mep
meer	'mer
meer-	'mer
meerdere	'mer-d@-r@
meerkeuze	mer-'k2-z@
meest	'mest
meestal	'mest-Al
meeste	'mes-t@
meesten	'mes-t@
meeuwis	'me-wIs
meevallen	'me-vA-l@
meg	'mex
meh-	'mE
mei	'mE+
meid	'mE+t
meiden	'mE+-d@
meis	'mE+s
meisje	'mE+-S@
meisjes	'mE+-S@s
meivakantie	'mE+-va-kAn-si
mekaar	m@-'kar
melden	'mEl-d@
me-met	mE-'mEt
memorabels	mE-mo-'ra-b@ls
memory	'me-mO-ri
men	'mEn
men-	'mEn
meneer	m@-'ner
menen	'me-n@
menig	'me-n@x
menig-	'me-n@G
menigte	'me-n@x-t@
mening	'me-nIN
mens	'mEns
mensen	'mEn-s@
mentor	'mEn-tOr
mentorgroepje	'mEn-tOr-Grup-j@
mentorkindje	'mEn-tOr-kIn-tj@
mentorkindjes	'mEn-tOr-kIn-tj@s
merk	'mErk
merken	'mEr-k@
merkt	'mErkt
merleyn	m@r-'lin
met	'mEt
meteen	m@-'ten
meten	'me-t@
meter	'me-t@r
met-met	'mEt-mEt
met-t-t	'mEt-t-t
meuk	'm2k
mevrouwtje	m@-'vrA+w-tj@
mezelf	m@-'zElf
mezz	'mEz
mfvn	Em-Ef-ve-'En
micha	'mI-xa
micha's	'mI-Sas
michie-	mI-'xI
michiel	mI-'xil
microfoon	mi-kro-'fon
middag	'mI-dAx
middagje	'mI-dAx-j@
middags	'mI-dAxs
middelbare	'mI-d@l-ba-r@
middelbareschooldocent	mI-d@l-ba-r@-'sxol-do-sEnt
midden	'mI-d@
middenin	mI-d@-'In
midweekje	'mId-wek-j@
mien	'mi
mientje	'min-tj@
mieren	'mi-r@
mij	'mE+
mijn	'mE+n
militaire	mi-li-'tE:-r@
miljard	m@l-'jArt
miljoen	m@l-'jun
millstreet	'mIl-strit
mi-middagen	mI-'mI-da-G@n
min	'mIn
min-	'mIn
mindcraft	'mAjn-kraft
minder	'mIn-d@r
minimaal	mi-ni-'mal
minor	'mi-nOr
minoren	mi-'no-r@n
minorvak	'mAj-nOr-vAk
minst	'mInst
minstens	'mIn-st@ns
minuten	mi-'ny-t@
minuut	mi-'nyt
minuutjes	mi-'nyt-j@s
mis	'mIs
mis-	'mIs
misbruik	mIz-'brY+k
misdaad	'mIz-dat
misgeschotters	'mIs-G@-sxO-t@rs
mislukt	mIs-'lYkt
missch-	'mIsx
misschien	mI-'sxin
misschoppers	'mIs-xO-p@rs
misselijk	'mI-s@-l@k
missen	'mI-s@
mission	'mI-S@n
mist	'mIst
mixen	'mIk-s@
mm	'Em-Em
m-m-	'mm
m-maken	m-'ma-k@n
m-marco	m-'mAr-ko
m-meer	m-'mer
m-meestal	m-'mes-tAl
m-met	m-'mEt
m-mocht	m-'mOxt
m-moet	m-'mut
m'n	'm@n
mo	'Em-o
mo-	'mo
mobiel	mo-'bil
mocht	'mOxt
mochten	'mOx-t@
model	mo-'dEl
modellen	mo-'dE-l@
modern	mo-'dErn
moderne	mo-'dEr-n@
moderner	mo-'dEr-n@r
moe	'mu
moe-	'mu
moeder	'mu-d@r
moeilijk	'muj-l@k
moeite	'muj-t@
moest	'must
moesten	'mus-t@
moet	'mut
moeten	'mu-t@
mogelijk	'mo-G@-l@k
mogelijkheden	'mo-G@-l@k-he-d@
mogelijkheiden	'mo-G@-lE+k-hE+-d@n
mogen	'mo-G@
molenstraat	'mo-l@-strat
molotov	'mO-lo-tOv
mome-	'mo-mE
moment	mo-'mA~
momenten	mo-'mEn-t@
momentje	mo-'mEnt-j@
monard	mO-'nArt
mond	'mOnt
money	'mO-nI
monitoren	'mo-ni-to-r@
monster	'mOn-st@r
monsters	'mOn-st@rs
montenegro	mOn-t@-'n@-Gro
montuur	mOn-'tyr
mooi	'moj
mooie	'mo-j@
moppen	'mO-p@
moraliteit	mo-ra-li-'tE+t
more-	'mor
moreel	mo-'rel
morele	mo-'re-l@
morgen	'mOr-G@
morgenochtend	mOr-G@-'Ox-t@nt
moskee	mOs-'ke
moslim	'mOs-lIm
moslimpartij	'mOs-lIm-pAr-tE+
moslimvrouwtjes	'mOs-lIm-vrA+w-tj@s
motherfucker	mO-tEr-'fY-kEr
motivatie	mo-ti-'va-tsi
mouwen	'mA+-w@
mri	Em-Er-'i
mtv	Em-te-'ve
much	'mYx
mulle	'mY-l@
munchk-	'mYnSk
munchkin-avond	'mYnS-kIn-a-vOnt
munchkin-avondje	'mYnS-kin-a-vOn-tj@
munten	'mYn-t@
music	my-'zIk
muur	'myr
muurtje	'myr-tj@
muziek	my-'zik
mwah	'mwa
n	'En
-n	'n
één	'en
n-	'n
na	'na
na-	'na
naaien	'na-j@
naam	'nam
naamplaatje	'nam-pla-tj@
naar	'nar
naartoe	nar-'tu
naast	'nast
nabespreking	'na-b@-spre-kIN
nabootsing	'na-bot-sIN
nac	'nAk
nacht	'nAxt
nachtje	'nAx-tj@
nachts	'nAxts
nachtschema	'nAxt-sxe-ma
nadeel	'na-del
nadenken	'na-dEN-k@
nadia	'na-di-ja
nadoen	'na-dun
nagedacht	'na-G@-dAxt
nah	'na
nam	'nAm
namelijk	'na-m@-l@k
namen	'na-m@
namibië	na-'mi-bi
namibiÃ«	namibi
nana	'na-na
na-na	'na-na
na-naar	na-'nar
nasi	'nA-si
nasynchroniseren	'na-sIn-xro-ni-ser-@n
nat	'nAt
nature	'na-tyr@
natuur	na-'tyr
natuurkunde	na-'tyr-kYn-d@
natuurlijk	na-'tyr-l@k
natuurrampen	na-'ty-rAm-p@
nazi	'na-tsi
nba	Em-be-'a
ne	'n@
ne-	'ne
nede-nederlander	ne-d@-'ne-d@r-lAn-d@r
nederland	'ne-d@r-lAnt
nederlanders	'ne-d@r-lAn-d@rs
nederlands	'ne-d@r-lAnts
nederlandse	'ne-d@r-lAnt-s@
nee	'ne
nee-	'ne
neef	'nef
neefje	'nef-j@
neem	'nem
neemt	'nemt
neen	'nen
neer	'ner
neergezet	'ner-G@-zEt
negatief	ne-Ga-'tif
negatieve	ne-Ga-'ti-v@
negen	'ne-G@
negende	'ne-G@n-d@
negenen	'ne-G@-n@
negenen-	'ne-G@-n@n
negenentwintig	'ne-G@n-En-twIn-t@x
negenhonderd	'ne-G@n-hOn-d@rt
negentien	'ne-G@n-tin
negenzeventig	'ne-G@n-@n-ze-v@n-t@x
neger	'ne-G@r
negeren	n@-'Ge-r@
neiging	'nE+-GIN
nelson	'nEl-sOn
nemen	'ne-m@
neou	'neA+
nep	'nEp
nereus	ne-'rY+s
nergens	'nEr-G@ns
net	'nEt
neten	'ne-t@
netjes	'nEt-j@s
neu	'n2
neuh	'n2
neurotisch	n2-'ro-tis
neus	'n2s
neutraal	n2-'tral
neven	'ne-v@
never	'ne-v@r
new	'njujuw
ni	'ni
ni-	'nI
nice	'nis@
niche	'nI-S@
nichterig	'nIx-t@-r@x
nichtjes	'nIxt-j@s
nick	'nIk
nico	'ni-ko
nie	'ni
nie-	'ni
niemand	'ni-mAnt
niet	'nit
niet-niet	'nit-nit
niet-rationeel	'nit-rA-tsio-nel
niets	'nits
niet-wandelaars	'nit-wan-d@-lars
nieuw	'niw
nieuwe	'ni-w@
nieuwer	'ni-w@r
nieuwjaar	'niw-jar
nieuw-journalisme	'niw-Zur-na-lIs-m@
nieuwkerk	'niw-kErk
nieuws	'niws
nieuwste	'niw-st@
nieuwsuur	'niws-yr
nigeria	ni-'G@-ri-ja
nijmegen	'nE+-me-G@n
niks	'nIks
nils	
nina	'ni-na
nivra	'nI-vra
nizar	ni-'zAr
nja	'njA
nlt	En-El-'te
één-één	'en-en
n-naar	n-'nar
n-nasi	n-'nA-si
n-nee	n-'ne
n-niet	n-'nit
n-nog	n-'nOG
n-normaal	nOr-'mal
n-normen	n-'nOr-m@n
n-nou	n-'nA+
nnu	En-En-'y
n-nu	n-'ny
no	'no
no-	'nO
nodig	'no-d@x
nodigde	'no-d@G-d@
noe-	'nu
noem	'num
noemden	'num-d@
noemen	'nu-m@
noemt	'numt
nog	'nOx
nogal	nOx-'Al
nog-g	'nOG-G
nogmaals	'nOx-mals
nog-nog	'nOG-nOG
nondeju	nOn-d@-'jy
nooit	'nojt
noorden	'nor-d@
nopjes	'nOp-j@s
normaal	nOr-'mal
normale	nOr-'ma-l@
north	'nort
nos	En-o-'Es
nou	'nA+
novem-	'no-vEm
november	no-'vEm-b@r
novi	'no-vi
nrc	En-Er-'se
nrcnext	En-Er-Se-'nEkst
ns	En-'Es
-ns	'ns
nsn	En-Es-'En
nu	'ny
nuance	ny-'wAn-s@
nuchterder	'nYx-t@r-d@r
nuh	'n2
nul	'nYl
num-	'nYm
nummer	'nY-m@r
nummers	'nY-m@rs
nut	'nYt
nutteloze	'nY-t@-lo-z@
nuttig	'nY-t@x
nuttige	'nY-t@-G@
nyenrode	'nE+-@n-ro-d@
o	'o
o-	'o
o-a-alsof	o-A-Als-'Of
obama	o-'ba-ma
obsessief	Op-sE-'sif
och	'Ox
ochtend	'Ox-t@nt
ochtends	'Ox-t@nts
oe	'u
oefen	'u-f@
oefenen	'u-f@-n@
oefening	'u-f@-nIN
oefeningen	'u-f@-nI-N@
oehoe	'u-hu
of	'Of
offers	'O-f@rs
officiÃ«le	O-fi-'Se-l@
of-of	'Of-Of
ogen	'o-G@
oh	'o
ojojoj	'Oj-Oj-Oj
ok	'ok
ok-	'Ok
oké	'o-ke
okÃ©	oke
ok-oktober	Ok-Ok-'to-b@r
oktober	Ok-'to-b@r
oktoberfeest	Ok-'to-b@r-fest
oktoberfest	Ok-'to-b@r-fEst
old	'Olt
oliver	'o-lAj-v@r
olive's	'O-lIf
olop	'O-lOp
om	'Om
om-	'Om
oma	'o-ma
omafiets	'o-ma-fIts
oma's	'o-mas
omdat	Om-'dAt
omgeving	Om-'Ge-vIN
omgooien	'Om-Go-j@
omheen	Om-'hen
omhoog	Om-'hox
omhoop	Om-'hop
omkleden	'Om-kle-d@
om-m	'Om-m
om-om	'Om-Om
omroep	'Om-rup
omroepen	'Om-ru-p@
omroepenwereld	'Om-ru-p@n-we-r@lt
omwonenden	Om-'wo-n@n-d@
omzet	Om-'zEt
on	'On
on-	'On
onafhankelijk	On-Af-'hAN-k@-l@k
onbelangrijk	Om-b@-'lAN-rE+k
onbeperkt	Om-b@-'pErkt
onbewust	Om-b@-'wYst
onder	'On-d@r
onderaf	On-d@r-'Af
onderbreking	On-d@r-'bre-kIN
ondergoed	'On-d@r-Gut
ondergoed-	'On-d@r-Gut
ondergronds	On-d@r-'GrOnts
onderin	On-d@r-'In
onderkant	'On-d@r-kAnt
onderscheid	On-d@r-'sxE+t
ondersteboven	On-d@r-st@-'bo-v@
ondertussen	On-d@r-'tY-s@
onderverhuren	'On-d@r-v@r-hy-r@
onderwerp	'On-d@r-wErp
onderwerpen	'On-d@r-wEr-p@
onderwijs	On-d@r-'wE+s
onderwijsblo-	'On-d@r-wE+s-blO
onderwijssysteem	'On-d@r-wE+-sis-tem
onderzoek	On-d@r-'zuk
onderzoeken	On-d@r-'zu-k@
onderzoeker	On-d@r-'zu-k@r
onderzoekers	On-d@r-'zu-k@rs
onderzoeksprofiel	'On-d@r-zuks-pro-fil
one	'O-n@
ongeacht	'ON-G@-Axt
ongemakkelijk	ON-G@-'mA-k@-l@k
ongeschreven	ON-G@-'sxre-v@
ongeveer	ON-G@-'ver
onhandig	On-'hAn-d@x
onkruid	'ON-krY+t
online	On-'lAj-n@
onno	O-'no
on-onder	On-'Ond@r
onopvallen-	'On-Op-vA-l@n
onopvallend	On-Op-'fA-l@nt
onrecht	'On-rExt
onrechtvaardigheid	On-rExt-'far-d@x-hE+t
ons	'Ons
ons-ons	'Ons-Ons
onszelf	On-'zElf
ontdekt	On-'dEkt
onterecht	'On-t@-rExt
onthoud	Ont-'hA+t
onthouden	Ont-'hA+-d@
ontslagen	Ont-'sla-G@
ontstaan	Ont-'stan
ontvreemd	Ont-'fremt
ontwikkeling	Ont-'wI-k@-lIN
ontwikkelingssamenwerking	Ont-'wI-k@-lIN-sa-m@n-wEr-kIN
ontzettend	Ont-'sE-t@nt
onvoldoende	'On-vOl-dun-d@
onze	'On-z@
onzin	'On-zIn
onzinnummers	'On-zIn-nY-m@rs
o-o-	'O-O
o-of	O-'Of
ooghoeken	'ox-hu-k@
ooit	'ojt
ook	'ok
o-oké	o-'o-ke
o-okÃ©	ooke
ook-ook	'ok-ok
oom	'om
o-om	o-'om
ooms	'oms
o-ontzettend	O-'Ont-zEt-@nt
o-ook	o-'ok
o-op	O-'Op
o-orderpicken	'or-d@r-pI-k@n
oor-oortjes	or-'or-tj@s
oost	'ost
oosterbeek	'os-t@r-bek
op	'Op
opa	'o-pa
opbouwen	'O-bA+-w@
opbouwend	'O-bA+-w@nt
opbreekt	'Op-brekt
opdagen	'Ob-da-G@
opdracht	'Ob-drAxt
opdrachten	'Ob-drAx-t@
opdrachtjes	'Ob-drAxt-j@s
opdringerig	Ob-'drI-N@-r@x
opeens	Op-'ens
open	'o-p@
opfokken	'Op-fO-k@n
opge-	'Op-G@
opgebouwd	'Op-x@-bA+wt
opgebroken	'Op-x@-bro-k@
opgedaan	'Op-x@-dan
opgefokte	'Op-x@-fOk-t@
opgegaan	'Op-x@-Gan
opgegeven	'Op-x@-Ge-v@
opgegooid	'Op-x@-Gojt
opgehangen	'Op-x@-hA-N@
opgekomen	'Op-x@-ko-m@
opgeleverd	'Op-x@-le-v@rt
opgelo-	'Op-G@-lO
opgenomen	'Op-x@-no-m@
opgericht	'Op-x@-rIxt
opgeruimd	'Op-x@-rY+mt
opgeschreven	'Op-x@-sxre-v@
opgestaan	'Op-x@-stan
opgestroopt	'Op-x@-stropt
opgevoed	'Op-x@-vut
opgevreten	'Op-x@-vre-t@
opgezet	'Op-x@-zEt
opgezocht	'Op-x@-zOxt
opgezweld	'Op-G@-zwElt
opgezwollen	'Op-x@-zwO-l@
ophangen	'Op-hA-N@
opium	'o-pi-jYm
oplawaai	'Op-lA-waj
oplee	'Op-le
opletten	'Op-lE-t@
opleveren	'Op-le-v@-r@
opn-	'Op-n
opnames	'Op-na-m@s
opnemen	'Op-ne-m@
opnieuw	Op-'niw
op-op	'Op-Op
oporto	'A-pO-t@
op-p	'Op-p
oppakken	'O-pA-k@
oppervlakte	'O-p@r-vlAk-t@
opposites	'O-po-sIts
oprecht	Op-'rExt
opricht	'Op-rIxt
oprisping	'Op-rIs-pIN
oproept	'Op-rupt
opruimen	'Op-rY+-m@
opscheppen	'Op-sxE-p@
opschieten	'Op-sxi-t@
opschrijven	'Op-sxrE+-v@
opslaan	'Op-slan
opsporen	'Op-spo-r@
opstaan	'Op-stan
opstelling	'Op-stE-lIN
opsturen	'Op-sty-r@
optie	'Op-si
opties	'Op-sis
optre-	'Op-tre
optreden	'Op-tre-d@
optredens	'Op-tre-d@ns
optreedt	'Op-tret
opv-	'Opv
opvallend	'Op-fA-l@nt
opzij	Op-'sE+
opzoeken	'Op-su-k@
oranje	o-'rA-J@
oranjepop	O-'rA-J@-pOp
order	'Or-d@r
orderpickbedrijf	'Or-d@r-pIk-b@-drE+f
orderpicken	'Or-d@r-pI-k@n
oren	'o-r@
organisatie	Or-Ga-ni-'za-tsi
oriÃ«nterend	o-ri-jEn-'te-r@nt
origineel	o-ri-Zi-'nel
orka	'Or-ka
ortho-	'Or-to
orthodox	Or-to-'dOks
orthodox-	'Or-to-dOks
orthodoxe	Or-to-'dOk-s@
oss	'Os
ou	'A+
oubeid	'A+-bE+t
oud	'A+t
oud-bestuur	'A+t-b@-styr
ouder	'A+-d@r
ouderdag	'A+-d@r-dAx
ouderen	'A+-d@-r@
ouders	'A+-d@rs
ouderwets	A+-d@r-'wEts
oudsher	A+ts-'hEr
out	'A+t
outfit	'A+t-fIt
ouwe	'A+-w@
ouwehoeren	A+-w@-'hu-r@
ov	o-'ve
over	'o-v@r
overal	'o-v@r-Al
overboord	o-v@r-'bort
overdag	o-v@r-'dAx
over-de-top-oktoberfeest	o-v@r-d@-tOp-Ok-'to-b@r-fest
overgeladen	'o-v@r-G@-la-d@
overgenomen	'o-v@r-G@-no-m@
overgeslagen	'o-v@r-G@-sla-G@
overgrote	'o-v@r-Gro-t@
overheen	o-v@r-'hen
overheid	'o-v@r-hE+t
overhoop	o-v@r-'hop
overigens	'o-v@-r@-G@ns
overkant	'o-v@r-kAnt
overleden	o-v@r-'le-d@
overleggen	o-v@r-'lE-G@
overlegorgaan	o-v@r-'lEx-Or-Gan
overlijdens	o-v@r-'lE+-d@ns
overlijdens-	'o-v@r-lE+-d@ns
overlijdensadvertenties	o-v@r-'lE+-d@s-At-f@r-tEn-sis
overmorgen	'o-v@r-mOr-G@
overneemt	'o-v@r-nemt
overnemen	'o-v@r-ne-m@
overnieuw	o-v@r-'niw
overspoeld	o-v@r-'spult
oversteken	'o-v@r-ste-k@
overstroming	o-v@r-'stro-mIN
overtreffen	o-v@r-'trE-f@
overtuigd	o-v@r-'tY+xt
overval	'o-v@r-vAl
overwogen	o-v@r-'wo-G@
overzichtelijk	o-v@r-'zIx-t@-l@k
ow	'ow
p	'pe
p-	'p
pa	'pa
paal	'pal
paar	'par
paarden	'par-d@
paars	'pars
pak	'pAk
pakken	'pA-k@
pakket	pA-'kEt
pakt	'pAkt
pan	'pAn
pand	'pAnt
paniek	pa-'nik
pannensets	'pA-n@n-sEts
pantalon	pAn-ta-'lOn
paparazzi	pA-pa-'rAd-zi
paper	'pa-p@r
papers	'pa-p@rs
papier	pa-'pir
papiertje	pa-'pir-tj@
paprikapoeder	'pa-prI-ka-pu-d@r
par	'pAr
par-	'pAr
paracetamolgeloof	pa-ra-se-ta-'mOl-G@-lof
parallel	pa-rA-'lEl
parcours	pAr-'kur
parel	'pa-r@l
parijs	pa-'rE+s
park	'pArk
parool	pa-'rol
participanten	pAr-ti-si-'pAn-t@
partij	pAr-'tE+
partij-	pAr-'tE+
partijen	pAr-'tE+-j@
partijleider	pAr-'tE+-lE+-d@r
partijprogramma	pAr-'tE+-pro-GrA-ma
partner	'pArt-n@r
party	'pAr-ti
pas	'pAs
passen	'pA:-s@
past	'pAst
patho	pA-'to
patricia	pA-'tri-si-ja
patserig	'pAt-s@-r@x
pau	'po
pau-	'pA+
paul	'pA+l
paulaantje	pA+-'lan-tj@
paulaner	pA+-'la-n@r
pauperstad	'pA+-p@r-stAt
paus	'pA+s
pauw	'pA+w
pauze	'pA+-z@
pauzetijd	'pA+-z@-tE+t
pe	'p@
pe-	'pe
pech	'pEx
pedagogische	pe-da-'Go-Gi-s@
pedofiel	pe-do-'fil
pedofiliteit	pe-do-fI-lI-'tE+t
penningmeester	'pE-nIN-mes-t@r
per	'pEr
peranoia	pE-rA-'nO-ja
perception	pEr-'sEp-sj@n
perfect	pEr-'fEkt
performance	p@r-'fOr-m@ns
persie	'pEr-zi
personalisering	pEr-so-na-lI-'se-rIN
personen	p@r-'so-n@
personificatie	pEr-so-ni-fi-'ka-tsi
persoon	p@r-'son
perz-perzische	pErz-'pEr-zi-s@
pest	'pEst
pet	'pEt
peter	'pe-t@r
peters	'pe-t@rs
petje	'p@t-j@
pf	'pf
pff	'pf
pickorder	'pIk-or-d@r
piet	'pit
pieter	'pi-t@r
pietje	'pit-j@
piew	'piw
piew-piew-piew	'piw-piw-piw
pijn	'pE+n
pil	'pIl
pils	'pIls
pim	'pIm
piraat	pi-'rat
pisang	'pI-sAN
pitten	'pI-t@
pixels	'pIk-s@ls
pizza	'pi-tsa
plaatje	'plat-j@
plaatjes	'plat-j@s
plaats	'plats
plaatsen	'plat-s@
plan	'plEn
planck	'plAnsk
planckonderzoekjes	'plAnk-On-d@r-zuk-j@s
planet	pla-'nEt
planken	'plAN-k@
plannen	'plE-n@
planning	'plE-nIN
plant	'plEnt
plantenbakkie	'plAn-t@n-bA-kI
plantje	'plAnt-j@
plantjes	'plAnt-j@s
plat	'plAt
platform	'plAt-fOrm
plato	'pla-to
platter	'plA-t@r
plausibel	plA+-'si-b@l
plein	'plE~
pleinen	'plE+-n@
plek	'plEk
plekken	'plE-k@
plezier	pl@-'zir
ploep	'plup
plus	'plYs
po	'po
po-	'pO
podium	'po-di-jYm
poe	'pu
poef	'puf
poeh	'pu
poel	'pul
poetin	'pu-tE:
poetsen	'put-s@
pokeren	'po-k@-r@
pokersets	'po-k@r-sEts
pokerta-	'po-k@r-ta
pokkenwerk	'pO-k@n-wErk
pol	'pOl
pol-	'pOl
politiebureau	po-'li-tsi-by-ro
politiek	po-li-'tik
polonaise	po-lo-'nE:-s@
pool	'pul
poolen	'pu-l@
poosje	'po-S@
popeye	'pop-eije
poppetje	'pO-p@-tj@
poppetjes	'pO-p@-tj@s
poppodium	'pO-po-di-um
poppodiumachtig	'pO-po-di-um-Ax-tix
popronde	'pOp-rOn-d@
populatie	po-py-'la-tsi
populisten	po-py-'lIs-t@
populistisch	pO-py-'lIs-tis
popzaal	'pOp-zal
porno	'pOr-no
pornocollectie	'pOr-no-kO-lEk-si
pornofi-	'pOr-no-fI
positie	po-'zi-tsi
positieve	po-zi-'ti-v@
posten	'pOs-t@
poster	'pos-t@r
posterpresentatie	'pos-t@r-pre-s@n-tat-si
postmodernisme	pOst-mo-dEr-'nIs-m@
poten	'po-t@
potje	'pOt-j@
potjes	'pOt-j@s
p-probleem	p-prO-'blem
p-psycholinguÃ¯stisch	ppsIxolINgwIstIxs
p-psycholinguïstisch	p-psI-xo-lIN-'gwIs-tIxs
pr	'pe-Er
praat	'prat
praatte	'pra-t@
prachtig	'prAx-t@x
practica	'prAk-ti-ka
pragmatisch	prAG-'ma-tis
pragmatisme	prAG-ma-'tIs-m@
praktisch	'prAk-tis
praktische	'prAk-ti-s@
praten	'pra-t@
prec-	'prEs
precies	pr@-'sis
precieze	pr@-'si-z@
premium	'pri-mi-Ym
presentaties	pre-zEn-'ta-tsis
presentatievaardigheden	pre-s@n-tat-si-'var-dIG-he-d@n
presentator	pre-zEn-'ta-tOr
presenteert	pr@-zEn-'tert
presenteren	pr@-zEn-'te-r@
pri-	'pri
priapia	pri-'a-pi-a
prices	'prAj-sEs
priester	'pris-t@r
prijs	'prE+s
prijsje	'prE+-S@
prijzen	'prE+-z@
prijzig	'prE+-z@x
prikbord	'prIg-bOrt
prikkel	'prI-k@l
prikkelen	'prI-k@-l@
prima	'pri-ma
princ-	'prIns
princip-	'prIn-sip
principe	prIn-'si-p@
principes	prIn-'si-p@s
principieel	prIn-si-'pjel
prins	'prIns
prioriteiten	pri-jo-ri-'tE+-t@
pripriapia	pri-pri-'a-pi-a
pr-man	pe-'Er-mAn
probeer	pro-'ber
probeert	pro-'bert
proberen	pro-'be-r@
probleem	pro-'blem
problemen	pro-'ble-m@
procent	pro-'sEnt
proces	pro-'sEs
processen	pro-'sE-s@
producten	pro-'dYk-t@
proef	'pruf
proefdraaien	'pruv-dra-j@
proefje	'pruf-j@
proefjes	'pruf-j@s
proefpersonen	'pruf-p@r-so-n@
proefpersonenpool	'pruf-pEr-so-n@n-pul
proefpersoonnuren	'pruf-pEr-son-y-r@n
proefpersoonuren	'pruf-p@r-son-y-r@n
proeven	'pru-v@
profielschets	pro-'fil-sxEts
profielstage	prO-'fil-sta-Z@
programma	pro-'GrA-ma
programma's	pro-'GrA-mas
programmeur	pro-GrA-'m2r
project	pro-'jEkt
projectjes	pro-'jEkt-j@s
propedeuse	pro-p@-'d2-s@
proppen	'prO-p@
protocol	pro-to-'kOl
p-ruyter	p-'rY+-t@r
psycho	'psi-o
psycholinguÃ¯stic	psIxolINgwIstIk
psycholinguïstic	'psI-xo-lIN-gwIs-tIk
psychologie	psi-xo-lo-'Gi
psychologisch	psi-xo-'lo-Gis
psychologische	psi-xo-'lo-Gi-s@
psychopaat	psi-xo-'pat
ptuup	p-'typ
pubkwis	'pYb-kwIs
publicatie	py-bli-'ka-tsi
publicatietje	pY-blI-'ka-tsi-tj@
publiceren	py-bli-'se-r@
puinhoop	'pY+n-hop
punt	'pYnt
punten	'pYn-t@
puntje	'pYnt-j@
pure	'py-r@
pushbericht	'pYS-b@-rIxt
pushberichten	'pYS-b@-rIx-t@n
puur	'pyr
puzzels	'pY-z@ls
puzzeltjes	'pY-z@l-tj@s
pvda	p-v-d-'a
pvv	pe-ve-'ve
pvv'er	pe-ve-'ve-@r
pvv'ers	pe-ve-'ve-@rs
pwc	pe-we-'se
pyjamaparty	pi-'ja-ma-pAr-ti
q	'k
q-	'kY
qua	'kwa
quality	'kwa-lI-ti
quasi	'kwa-zi
question	'kwEs-tj@n
questions	'kwEs-tjYns
r	'r
r-	'r
raam	'ram
raar	'rar
raarder	'rar-d@r
raars	'rars
rachel	rA-'x@l
racket	'rE-k@t
radboud	'rAd-bA+t
radicale	ra-di-'ka-l@
radicaliseert	rA-di-ka-li-'sert
radio	'ra-di-jo
rage	'ra-Z@
rai	'rj
raken	'ra-k@
rammen	'rA-m@
ramp	'rAmp
randdebiel	'rAn-d@-bil
random	'rEn-dOm
rapteksten	'rEp-tEks-t@n
raquel	rA-'kEl
rare	'ra-r@
rattige	'rA-t@-G@
re	're
reactie	re-'jAk-si
reactietijd	're-Ak-si-tE+t
reactievermogen	re-'jAk-si-v@r-mo-G@
reageert	re-ja-'Gert
reageren	re-ja-'Ge-r@
realement	rI-'A-l@-mEnt
realisme	re-ja-'lIs-m@
realistisch	re-ja-'lIs-tis
realistische	re-ja-'lIs-ti-s@
rechten	'rEx-t@
rechties	'rEx-tis
rechts	'rExts
rechtse	'rExt-s@
rechtvaardig	rExt-'far-d@x
rechtvaardig-	rExt-'var-d@x
rechtvaardiging	rExt-'far-d@-GIN
reclame	r@-'kla-m@
reconstr-	're-KOn-str
reconstructie	re-kOn-'strYk-si
redde	'rE-d@
redden	'rE-d@
redelijk	're-d@-l@k
redelijkheid	're-d@-l@k-hE+t
reden	're-d@
redenen	're-d@-n@
redeneren	re-d@-'ne-r@
reepjes	'rep-j@s
referentie	re-f@-'rEn-si
reg	'rEx
regel	're-G@l
regelen	're-G@-l@
regelmatig	re-G@l-'ma-t@x
regels	're-G@ls
regelt	're-G@lt
regen	're-G@
regenachtig	're-G@n-Ax-t@x
regende	're-G@n-d@
reggae	'rE-ge
regio	're-Gi-jo
regio-	're-Gi-o
regionale	re-Gi-jo-'na-l@
regio's	're-Gi-jos
reikt	'rE+kt
reizen	'rE+-z@
reizende	'rE+-z@n-d@
rek	'rEk
rekenen	're-k@-n@
rekening	're-k@-nIN
rekeningnummer	're-k@-nIN-nY-m@r
relax	ri-'lEks
relaxed	ri-'lEkst
relaxt	ri-'lEkst
relaxte	ri-'lEkst@
relaxter	ri-'lEk-st@r
remixen	're-mIk-s@n
ren	'rEn
rené	re-'n@
renÃ©	ren@
reünistendag	re-Y-'nIs-t@n-dAG
rennen	'rE-n@
repet-	're-p@t
repetitie	re-p@-'ti-tsi
repetities	re-p@-'ti-tsis
replica's	're-pli-kas
representatief	re-pre-sEn-ta-'tif
representatievaardigheden	're-pre-sEn-ta-tsi-var-dIG-he-d@n
representeren	re-pre-sEn-'te-r@
rereldoorlog	're-r@ld-or-lOG
researcher	'ri-s@r-tS@r
resident	re-zi-'dEnt
respectabele	rEs-pEk-'ta-b@-l@
rest	'rEst
restaurant	rEs-to-'rAnt
retourbon	r@-'tur-bOn
retro	're-tro
reÃŒnistendag	reYnIst@ndAG
rianne	ri-'jA-n@
rib	'rIp
richting	'rIx-tIN
richtingen	'rIx-tI-N@
ricky	'rI-ki
riep	'rip
rij	'rE+
rijden	'rE+-d@
rijdt	'rE+t
rijenr-	'rE+-@n-r
rijpen	'rE+-p@
rik	'rIk
rings	'rINs
risico	'ri-zi-ko
ritme	'rIt-m@
rob	'rOp
robert	'ro-bE:rt
robin	'ro-bin
roda	'ro-da
roddels	'rO-d@ls
roeien	'ru-j@
roeit	'rujt
roel	'rul
roepen	'ru-p@
roept	'rupt
roermond	rur-'mOnt
roesten	'rus-t@
rogier	ro-'Gir
rol	'rOl
rolcontainers	'rOl-kOn-te-n@rs
rollen	'rO-l@
romantisch-komisch	rO-'mAn-tis-ko-mis
rommel	'rO-m@l
ron	'rOn
rond	'rOnt
ronde	'rOn-d@
rondes	'rOn-d@s
rondje	'rOn-tj@
rondjes	'rOn-tj@s
rondlopen	'rOnd-lo-p@
rood	'rot
roodharige	'rot-ha-r@-G@
rooie	'ro-j@
roosendaal	'ro-z@-dal
roosje	'ros-j@
rooster	'ros-t@r
roosters	'ros-t@rs
rosa	'ro-sa
rose	'ro-z@
rÃ¶sti	rYstI
rotonde	ro-'tOn-d@
rotterdam	'rO-t@r-dAm
rotzooi	'rOt-soj
rouleren	ru-'le-r@
rousseau	ru-se-'jo
route	'ru-t@
routes	'ru-t@s
routine	ru-'ti-n@
rösti	'rYs-tI
rtl4	Er-te-El-'vir
rug	'rYx
ruig	'rY+x
ruim	'rY+m
ruimen	'rY+-m@
ruimte	'rY+m-t@
ruis	'rY+s
ruk	'rYk
rum	'rYm
rusland	'rYs-lAnt
russische	'rY-si-s@
rust	'rYst
rustig	'rYs-t@x
rustiger	'rYs-t@-G@r
ruyter	'rYi-t@r
s	'Es
s-	's
sa	'sa
sa-	'sA
saai	'saj
saaie	'sa-j@
saaiste	'saj-st@
sabbels	'sA-b@ls
sad	'sAd
sad-	'sAt
salade	sa-'la-d@
salaris	sa-'la-r@s
salto	'sAl-to
sam	'sam
samen	'sa-m@
samena	'sA-me-na
samengevat	'sa-m@-G@-vAt
samenleving	'sa-m@n-le-vIN
samenstel	'sa-m@n-stEl
samenvatting	'sa-m@n-vA-tIN
samenwerken	'sa-m@n-wEr-k@
samenwonen	'sa-m@n-wo-n@
sammie	'sA-mi
sammy	'sa-mi
samson	'sam-sO:n
san	'sAn
sander	'sAn-d@r
sanne	'sA-n@
satan	'sa-tAn
satÃ©saus	sat@sA+s
satésaus	sa-'t@-sA+s
sauna	'sA+-na
sbs6	Es-be-Es-'Es
scan	'skEn
scannen	'skE-n@
scant	'skEnt
scene	'sin
scha	'sxa
scha-	'sxa
schaakbord	'sxag-bOrt
schaamde	'sxam-d@
schaap	'sxap
schaar	'sxar
schaatsuitslagen	'sxats-Y+t-sla-G@n
schadelijk	'sxa-d@-l@k
schaffen	'sxA-f@
schaken	'sxa-k@
schalen	'sxa-l@
schandalig	sxAn-'da-l@x
schapen	'sxa-p@
schat	'sxAt
scheef	'sxef
scheelt	'sxelt
scheet	'sxet
scheiding	'sxE+-dIN
scheikunde	'sxE+-kYn-d@
scheldens	'sxEl-d@ns
scheldwoorden	'sxEld-wor-d@
scherm	'sxErm
schermen	'sxEr-m@
scheurt	'sx2rt
schiermonnikoog	sxir-mO-n@k-'ox
schiet	'sxit
schieten	'sxi-t@
schig	'sxIG
schijf	'sxE+f
schijnbaar	'sxE+m-bar
schijnheilig	sxE+n-'hE+-l@x
schijnt	'sxE+nt
schijtchristelijke	'sxE+t-krIs-t@-lE+-k@
schijthekel	'sxE+-te-k@l
schijttaakjes	'sxE+t-tak-j@s
schijtwerk	'sxE+t-wErk
schild	'sxIlt
schilderij	sxIl-d@-'rE+
schilderijtjes	sxIl-d@-'rE+-tj@s
schizofreen	sxi-tso-'fren
schoen	'sxun
schoenen	'sxu-n@
schoenpoetser	'sxun-put-s@r
schok	'sxOk
schokken	'sxO-k@
school	'sxol
schooljaar	'sxol-jar
schoon	'sxon
schoonmaakmiddel	'sxon-mak-mI-d@l
schoonmaken	'sxon-ma-k@
schoppen	'sxO-p@
schot	'sxOt
schotse	'sxOt-s@
schouder	'sxA+-d@r
schraven	'sxra-v@
schreef	'sxref
schrijven	'sxrE+-v@
schrijver	'sxrE+-v@r
schrikken	'sxrI-k@
schrobber	'sxrO-b@r
schroevendraaier	'sxru-v@-dra-j@r
schrok	'sxrOk
schudden	'sxY-d@
schuiven	'sxY+-v@
schuur	'sxyr
schuurpapier	'sxyr-pa-pir
schuurt	'sxyrt
scientology	sA-j@n-'tO-lO-gi
scientologykerk	sA-j@n-'tO-lO-gi-kErk
scouting	'skA+-tIN
scriptie	'skrIp-si
se	's@
se-	'se
sea	'si
secretariaat	se-kr@-ta-ri-'jat
secretarisdingen	se-kr@-'ta-rIs-dI-N@n
sector	'sEk-tOr
seinfeld	'sAjn-fElt
seizoen	sE+-'zun
sek-	'sEk
seks	'sEks
seksleven	'sEks-le-v@
seksuele	sEk-sy-'we-l@
selectie	s@-'lEk-si
senior	'se-ni-jOr
sensortje	'sEn-sOr-tj@
september	sEp-'tEm-b@r
seri-	'se-ri
serie	'se-ri
serieu	'se-ri-2
serieus	se-ri-'j2s
serieus-s	se-ri-'2s
serieuze	se-ri-'j2-z@
serre	'sE:-r@
servicemedewerker	's@r-f@s-me-d@-wEr-k@r
servische	'sEr-vi-s@
set	'sEt
setje	'sEt-j@
setting	'sE-tIN
sexy	'sEk-si
sh	'S
sh-	'S
sheets	'Sits
shijk	'Sik
shirt	'SYrt
shit	'SIt
shizzle	'SI-z@l
shk	'Sk
shockje	'SOk-j@
shooters	'Su-t@rs
shoppen	'SO-p@
shops	'SO-ps
short	'SOrt
shotje	'SOt-j@
show	'Sow
sightseeing	'sAjt-si-jIN
silences	'sAj-l@n-s@s
simon	'sI-mOn
simone	sI-'mo-n@
simpel	'sIm-p@l
simpson	'sImp-sOn
simpsons	'sImp-sOs
sinds	'sInts
sint	'sInt
sinterklaas	'sIn-t@r-klas
sinterklaasmijters	sIn-t@r-'klas-mE+-t@rs
sis	'sIs
s-is	s-'Is
site	'sAjt
sites	'sit@s
sittard	's-tArt
situaties	si-ty-'wa-tsis
sj-	'S
sjimmie	'sdZi-mi
sjoerd	'srt
sjors	'sOrs
sjouwen	'SA+-w@
sketch	'skEtS
skyboxvoetbal	'skAj-bOks-fut-bAl
skyrim	'skAj-rIm
sla	'sla
slaan	'slan
slaap	'slap
slaapplek	'sla-plEk
slaapt	'slapt
slaat	'slat
slacentrifuge	'sla-sEn-trI-fy-Z@
slalommen	'sla-lO-m@
slap	'slAp
slapen	'sla-p@
slavinkje	'sla-vInk-j@
slecht	'slExt
slechte	'slEx-t@
slechtste	'slExt-st@
sleutel	'sl2-t@l
sliep	'slip
slimme	'slI-m@
slingeren	'slI-N@-r@
slingers	'slI-N@rs
sloeg	'slux
slopen	'slo-p@
slot	'slOt
sloten	'slo-t@
slow	'slow
smaak	'smak
smerig	'sme-r@x
smikkelclub	'smI-k@l-klYp
snap	'snAp
snappen	'snA-p@
snapte	'snAp-t@
sneeuwen	'sne-w@
snel	'snEl
snelle	'snE-l@
sneller	'snE-l@r
snel-snelle	snEl-'snE-l@
snoekduik	'snuk-dY+k
snoepje	'snup-j@
snuitje	'snY+-tj@
so	'so
so-	'so
soberder	'so-b@r-d@r
soccie	'sOk-si
sociaal	so-'Sal
sociale	so-'Sa-l@
sociÃ«teit	so-si-j@-'tE+t
sociÃ«teiten	sosijetE+t@n
society	so-'sA-j@-ti
sociologische	so-So-'lo-Gi-s@
sociëteiten	'so-si-je-tE+-t@n
sodom	'so-dOm
soepkommen	'sup-kO-m@
soft	'sOft
solar	'so-lAr
solidariteit	so-li-da-ri-'tE+t
sommige	'sO-m@-G@
sommigen	'sO-m@-G@
soms	'sOms
soort	'sort
soorten	'sor-t@
soph-	'sof
sophie	sO-'phi
sorry	'sO-ri
south	'sA+t
sowie-	'so-wi
sowieso	'zo-wi-zo
spaans	'spans
spaarcenten	'spar-sEn-t@
spaghetti	spA-'GE-ti
spammen	'spE-m@n
spanning	'spA-nIN
speciaal	spe-'Sal
speciaals	spe-'Sals
special	'spE-S@l
speciale	spe-'Sa-l@
specialiseren	spe-Sa-li-'ze-r@
specifiek	spe-si-'fik
specifieke	spe-si-'fi-k@
speech	'spitS
speel	'spel
speelt	'spelt
speelveld	'spel-vElt
spek	'spEk
spekjes	'spEk-j@s
spekman	'spEk-mAn
spel	'spEl
spelen	'spe-l@
spelend	'spe-l@nt
spellen	'spE-l@
spelletje	'spE-l@-tj@
spelletjes	'spE-l@-tj@s
spelletjesavond	'spE-l@-tj@s-a-vOnt
sperziebonen	'spEr-zi-bo-n@
spierpijn	'spir-pE+n
spijker	'spE+-k@r
spijker-	'spE+-k@r
spijkerbroeken	'spE+-k@r-bru-k@
spinnen	'spI-n@
spinoza	spi-'no-za
spinozazaal	spI-'no-za-zal
spits	'spIts
spoiler	'spOj-l@r
sponsjes	'spOn-S@s
spontaan	spOn-'tan
spoor	'spor
spoot	'spot
sport	'spOrt
sporten	'spOr-t@
sportnieuws	'spOrt-niws
sportscholen	'spOrt-sxo-l@
sportschool	'spOrt-sxol
sportzaak	'spOrt-zak
spraak	'sprak
spreek	'sprek
spreekt	'sprekt
spreken	'spre-k@
sprietjes	'sprit-j@s
springen	'sprI-N@
sprong	'sprON
sp-sportschooltje	sp-'spOrt-sxol-tj@
spul	'spYl
spullen	'spY-l@
spuwde	'spyw-d@
srietje	'srit-j@
ss	Es-'Es
s-s	s-'s
s-'s	s-'s
s-setje	s-'sEt-j@
ssn	Es-Es-Ha-'En
s-soms	s-'sOms
s-sorry	s-'sO-ri
s-steek	s-'stek
s-stinkhol	s-'stInk-hol
s-straks	s-'strAks
s-stront	s-'strOnt
st	'st
st-	'st
sta	'sta
sta-	'sta
staa-	'sta
staan	'stan
staat	'stat
stad	'stAt
staf	'stAf
stage	'sta-Z@
stak	'stAk
stampen	'stAm-p@
stampertje	'stAm-p@r-tj@
stan	'stAn
standaard	'stAn-dart
stang	'stAN
stap	'stAp
stappen	'stA-p@
stapt	'stApt
startsein	'stArt-sE+n
starttijd	'stAr-tE+t
state	'sta-t@
statements	'stet-m@nts
station	stA-'tSOn
stations	stA-'tSOns
stationshal	stA-'tSOns-hAl
stationsplein	stA-'tSOns-plE+n
statisch	'sta-tis
statistisch	sta-'tIs-tis
status	'sta-tYs
steeds	'stets
steekt	'stekt
steel	'stel
steken	'ste-k@
stekker	'stE-k@r
stel	'stEl
stelen	'ste-l@
stelle-	'stE-l@
stellen	'stE-l@
stelletje	'stE-l@-tj@
stelt	'stElt
stem	'stEm
stemmen	'stE-m@
stemmige	'stE-m@-G@
stempel	'stEm-p@l
stempelen	'stEm-p@-l@
stempels	'stEm-p@ls
stenen	'ste-n@
stereotiep	ste-rE-o-'tIp
sterk	'stErk
sterke	'stEr-k@
sterkste	'stErk-st@
steve	'ste-v@
stichting	'stIx-tIN
stichtings	'stIx-tINs
stiekem	'sti-k@m
stift	'stIft
stijl	'stE+l
stijn	'stE+n
stil	'stIl
stilstaand	'stIl-stant
stoa	'sto-a
stoïci	sto-'I-sE+
stoel	'stul
stoelen	'stu-l@
stoer	'stur
stoÃ¯ci	stoIsE+
stoken	'sto-k@
stom	'stOm
stomme	'stO-m@
ston-	'stOn
stond	'stOnt
stonden	'stOn-d@
stoned	'stont
stoot	'stot
stop	'stOp
stopgezet	'stOp-x@-zEt
stoppe-	'stO-p@
stoppen	'stO-p@
stormbaan	'stOrm-ban
story	'stO-ri
straalbezopen	'stral-b@-zo-p@n
straat	'strat
straatkant	'strat-kAnt
straf	'strAf
straight	'strE+t
strak	'strAk
strakke	'strA-k@
straks	'strAks
strategieÃ«n	strateGij@
strategieën	'stra-te-Gi-j@
stre-	'stre
strebertjes	'stre-b@r-tj@s
streek	'strek
streepje	'strep-j@
strekking	'strE-kIN
strenge	'strE-N@
strepen	'stre-p@
stress	'strEs
strook	'strok
strookt	'strokt
stroom	'strom
structuur	strYk-'tyr
struikelblok	'strY+-k@l-blOk
studeert	sty-'dert
student	sty-'dEnt
studenten	sty-'dEn-t@
studentenballetje	stY-'dEnt-bA-l@-tj@
studentenspelletjes	stY-'dEn-t@n-spE-l@-tj@s
studentenstad	sty-'dEn-t@-stAt
studententijd	sty-'dEn-t@-tE+t
studentenvereniging	sty-'dEn-t@-v@-re-n@-GIN
studentenwoning	sty-'dEn-t@n-vo-niN
studeren	sty-'de-r@
studie	'sty-di
studiedagen	'sty-di-da-G@
studiegids	'sty-di-GIts
studievereniging	'sty-di-v@-re-n@-GIN
studio	'sty-di-jo
stuk	'stYk
stukje	'stYk-j@
stukjes	'stYk-j@s
stukken	'stY-k@
stukkenbroek	'stY-k@n-bruk
sturen	'sty-r@
stuur	'styr
stuurt	'styrt
subject	'sYb-jEkt
subjectieve	sYb-jEk-'ti-v@
subsidie	'sYp-si-di
succes	syk-'sEs
suden	'sy-d@n
suf	'sYf
sukkels	'sY-k@ls
sultan	'sYl-tAn
super	'sy-p@r
superbrak	sy-p@r-'brAk
superchill	sy-p@r-'tSIl
superdruk	sy-p@r-'drYk
supergoed	sy-p@r-'Gut
supergrappig	sy-p@r-'GrA-p@x
supergroot	sy-p@r-'Grot
superjournalistieke	sY-p@r-Zur-na-lIs-'ti-k@
superkut	sy-p@r-'kYt
superlang	sy-p@r-'lAN
superleuk	sy-p@r-'l2k
superleuke	sy-p@r-'l2-k@
superlichte	sY-p@r-'lix-t@
supermakkelijk	sy-p@r-'mA-k@-l@k
supermarkt	'sy-p@r-mArkt
supermooi	sy-p@r-'moj
supern-	'sy-p@r-n
supernatural	su-p@r-'nA-tju-rAl
superraar	sy-p@-'rar
superrandom	sy-p@r-'rAn-dYm
superveel	sy-p@r-'vel
supervet	sy-p@r-'vEt
superzuur	sy-p@r-'zyr
surinamer	sy-ri-'na-m@r
surprises	sYr-'pri-s@s
suup-	'sup
sven	'sv@
switchen	'swIt-S@
systeem	sis-'tem
system	si-'stEm
t	'te
-t	't
t-	't
ta	'ta
ta-	'tA
taak	'tak
taal	'tal
taallichaamonderzoek	'tal-li-xam-On-d@r-zuk
taalonderzoek	'tal-On-d@r-zuk
tachtig	'tAx-t@x
tactisch	'tAk-tis
tafel	'ta-f@l
tafels	'ta-f@ls
tak	'tAk
take	'tek
taken	'ta-k@
takt	'tAkt
talen	'ta-l@
talentvolle	ta-'lEnt-fO-l@
tanden	'tAn-d@
tankstation	'tENk-stA-tSOn
tankstations	'tENk-stA-tSOns
tante	'tAn-t@
tantes	'tAn-t@s
tapen	'te-p@
tas	'tAs
tasje	'tAs-j@
tassen	'tA-s@
tattooshop	tA-'to-SOp
taxi's	'tAk-sis
te	't@
team	'tim
techn-	'tEx-n
techniek	tEx-'nik
technieken	tEx-'ni-k@
technisch	'tEx-nis
technische	'tEx-ni-s@
techno	'tEx-no
technodingen	'tEx-no-di-N@n
technofeest	'tEx-no-fest
technologie	tEx-no-lo-'Gi
teerden	'ter-d@n
teert	'tert
-teert	'tert
teeven	'te-v@
tege-	'te-G@
tegelijk	t@-G@-'lE+k
tegelijkertijd	t@-G@-lE+-k@r-'tE+t
tegels	'te-G@ls
tegeltjes	'te-G@l-tj@s
tegen	'te-G@
tegenaan	te-G@-'an
tegenop	te-G@-'Op
tegenover	te-G@-'o-v@r
tegenstelling	'te-G@-stE-lIN
tegenwoordig	te-G@-'wor-d@x
teken	'te-k@
tekening	'te-k@-nIN
tekens	'te-k@ns
tekst	'tEkst
teksten	'tEks-t@
tekstvereisten	'tEkts-v@r-E+s-t@n
tel	'tEl
telefoon	te-l@-'fon
telegraaf	te-l@-'Graf
telegraaflezer	te-l@-'Graf-le-z@r
teleu-	't@-l2
teleurstellend	t@-'l2r-stE-l@nt
televi-	'te-l@-vi
televisie	te-l@-'vi-zi
tellen	'tE-l@
telling	'tE-lIN
tempe	'tEm-pe
tempe-	'tEm-p@
tempelier	tEm-p@-'lir
ten	'tEn
tenm-	'tEn-m
tenminste	tEn-'mIn-st@
tennis	'tE-n@s
tennisracket	'tE-n@s-rE-k@t
tennissen	'tE-n@-s@
tent	'tEnt
tentamen	tEn-'ta-m@
tenten	'tEn-t@
tenzij	tEn-'zE+
terecht	t@-'rExt
terloops	tEr-'lops
termijnsgeheugen	tEr-'mE+ns-G@-h2-G@n
terrein	tE-'rE+n
terug	t@-'rYx
teruggeeft	t@-'rY-Geft
teruggekeken	t@-'rY-G@-ke-k@
teruggeven	t@-'rY-Ge-v@
teruggezet	t@-'rY-G@-zEt
terugke-	't@-rYG-ke
terugkijken	t@-'rYx-kE+-k@
terugkomen	t@-'rYx-ko-m@
terugkomt	t@-'rYx-kOmt
terugvalt	t@-'rYx-fAlt
terugwerkende	t@-'rYG-wEr-k@n-d@
terwijl	tEr-'wE+l
testen	'tEs-t@
testje	'tEs-tj@
testobject	'tEst-Ob-jEkt
tests	'tEsts
te-te	'tE-tE
teun	't2n
teveel	t@-'vel
tevoren	t@-'vo-r@
teweeg	t@-'wex
tex-	'tEs
texel	'tEk-s@l
thailand	'th-lAnt
the	'te
theaterruimte	te-'ja-t@-rY+m-t@
theologie	te-jo-lo-'Gi
theorie	te-jo-'ri
theories	te-o-'ris
thijs	'thE+s
-thode	'to-d@
thomas	'to-mAs
thrillers	'trI-l@rs
thrillerschrijver	'trI-l@r-sxrE+-v@r
thuis	'tY+s
thuiskomt	'tY+s-kOmt
thuiswonend	'thY+s-wo-n@nt
ti-	'tI
tien	'tin
tienduizend	'tin-dY+-z@nt
tienrittenkaart	tin-'rI-t@-kart
tientje	'tin-tj@
tientjes	'tin-tj@s
tiÃ«sto	tIEsto
tieten	'ti-t@
tijd	'tE+t
tijden	'tE+-d@
tijdens	'tE+-d@ns
tijdje	'tE+t-j@
tijdschrift	'tE+t-sxrIft
tijdsdruk	'tE+dz-drYk
tijdstip	'tE+t-stIp
tik	'tIk
tikken	'tI-k@
tilburg	'tIl-b@rx
tillen	'tI-l@
tim	'tIm
time	'tAjm
timeline	'tAjm-lAjn
timo	'ti-mo
ting	'tIN
tis	'tIs
tiësto	'tIEs-to
tja	'tSa
tja-a	'tSa
to	'to
toch	'tOx
toe	'tu
toegevoegde	'tu-G@-vuG-d@
toen	'tun
toepassing	'tu-pA-sIN
toepast	'tu-pAst
toeren	'tu-r@
toerist	tu-'rIst
toerroeien	'tu-ru-j@n
toerroeiers	'tu-ru-j@rs
toespraak	'tu-sprak
toestanden	'tu-stAn-d@
toe-toen	tu-'tun
toetpassing	'tut-pA-sIN
toevallig	tu-'vA-l@x
toevoegt	'tu-vuxt
toewerkt	'tu-wErkt
tof	'tOf
toffer	'tO-f@r
tofu	tO-'fu
toko	'to-ko
tokootje	'to-ko-tj@
tolerant	to-l@-'rAnt
toleranter	to-l@-'rAn-t@r
tolkien	tOl-'ki
tom	'tOm
tomaat	to-'mat
ton	'tOn
toontje	'ton-tj@
top	'tOp
tophit	'tOp-hIt
tot	'tOt
totaal	to-'tal
totdat	tO-'dAt
tots	'tOts
tot-s	'tOts
tr-	'tr
tradities	tra-'di-tsis
trailers	'tre-l@rs
trainen	'tre-n@
training	'tre-nIN
trance	'trAns
transcriberen	trAn-skri-'be-r@
traptredes	'trAp-trE+-d@s
travolta	tra-'vOl-ta
tray	'tre
treden	'tre-d@
trein	'trE+n
treintje	'trE+n-tj@
trek	'trEk
trekken	'trE-k@
triestheid	'trist-hE+t
triktrak	'trIk-trAk
triktrek	'trIk-trEk
tristan	'trIs-tAn
triviant	tri-vi-'jAnt
trok	'trOk
trommels	'trO-m@ls
trompet	trOm-'pEt
trompetten	trOm-'pE-t@
trots	'trOts
trouw	'trA+w
trouwens	'trA+-w@ns
trouwens\	
trrrrrr	'trr
trucje	'tryk-j@
trui	'trY+
truien	'trY+-j@
truman	'try-mAn
ts	'ts
ts-	'ts
tsussauds	tsY-'so
tt	'ti-ti
-t-t	'tt
t-t	't-t
t-t-	't-t
t-te-	't-t@
t-tim	t-'tIm
t-toen	t-'tun
t-twaalf	t-'wAlf
t-tweede	t-'twe-d@
t-twintig	t-'twIn-t@x
tu	'ty
tu-	'ty
tuddededeluh	'tu-d@-d@-d@-lu
tuin	'tY+n
tuindingen	'tY+n-dI-N@n
tuinen	'tY+-n@
tuinp-	'tY+n-p
tuinstoelen	'tY+n-stu-l@
tuouem	'ty-oy-em
turk	'tYrk
tussauds	tY-'so
tussen	'tY-s@
tussendoor	tY-s@-'dor
tussenruimte	'tY-s@-rY+m-t@
tussenzaal	'tY-s@n-zal
tutututututututuh	'ty-ty-ty-ty-ty-ty-ty-ty
tuurlijk	'tyr-l@k
tv	te-'ve
tva	te-ve-'a
tv-show	te-'ve-SOw
tv'tje	te-'ve-tj@
twaalf	'twalf
twan	'twAn
twan-staat-als-een-huys	twAn-stat-Als-en-'hY+s
twee	'twe
tweede	'twe-d@
tweedehands	twe-d@-'hAnts
tweeÃ«n	twej@
tweeÃ«nhalf	twejEnhAlf
tweeÃ«nhalve	twejEnhAlv@
tweeÃ«nnegentig	twejEneG@nt@x
tweehonderd	'twe-hOn-d@rt
tweeën	'twe-j@
tweeënhalf	twe-jEn-'hAlf
tweeënhalve	twe-jEn-'hAl-v@
tweeënnegentig	twe-jE-'ne-G@n-t@x
twijfel	'twE+-f@l
twijfelen	'twE+-f@-l@
twintig	'twIn-t@x
twist	'twIst
twitter	'twI-t@r
twitteren	'twI-t@-r@n
two	'to
tyfen	'ti-f@n
tyfus	'ti-fYs
tyfusbende	'tI-fYs-bEn-d@
typetje	'ti-p@-tj@
typisch	'ti-pis
u	'y
u-	'y
ÃŒberhaupt	yb@rhA+pt
uh	'@
uit	'Y+t
uitademt	'Y+t-a-d@mt
uitdelen	'Y+-de-l@
uitdruk	'Y+-drYk
uiteindelijk	Y+t-'E+n-d@-l@k
uiteraard	Y+-t@r-'art
uitga	'Y+t-xa
uitgaan	'Y+t-xan
uitgaanspersoon	'Y+t-Gans-p@r-son
uitgangspunt	'Y+t-xANs-pYnt
uitge-	'Y+t-G@
uitgebreid	'Y+t-x@-brE+t
uitgebreide	'Y+t-x@-brE+-d@
uitgedaan	'Y+t-x@-dan
uitgedroogd	'Y+t-x@-droxt
uitgegeven	'Y+t-x@-Ge-v@
uitgehuwd	'Y+t-x@-hywt
uitgekozen	'Y+t-x@-ko-z@
uitgelegd	'Y+t-x@-lExt
uitgemeten	'Y+t-x@-me-t@
uitgenodigd	'Y+t-x@-no-d@xt
uitgerust	'Y+t-x@-rYst
uitgeschreven	'Y+t-x@-sxre-v@
uitgespeeld	'Y+t-x@-spelt
uitgesproken	'Y+t-x@-spro-k@
uitgeven	'Y+t-xe-v@
uitgezet	'Y+t-x@-zEt
uitgezonden	'Y+t-x@-zOn-d@
uitgooien	'Y+t-xo-j@
uitgraven	'Y+t-xra-v@
uitkiezen	'Y+t-ki-z@
uitl-	'Y+tl
uitleggen	'Y+t-lE-G@
uitlegt	'Y+t-lExt
uitloopt	'Y+t-lopt
uitmoordt	'Y+t-mort
uitnodigen	'Y+t-no-d@-G@
uitreiking	'Y+t-rE+-kIN
uitschrijven	'Y+t-sxrE+-v@
uitslag	'Y+t-slAx
uitslapen	'Y+t-sla-p@
uitspraak	'Y+t-sprak
uitstaan	'Y+t-stan
uitstapje	'Y+t-stAp-j@
uitstek	'Y+t-stEk
uitstroom	'Y+t-strom
uittrekt	'Y+-trEkt
uitverkocht	'Y+t-f@r-kOxt
uitvoeren	'Y+t-fu-r@
uitvoerig	Y+t-'fu-r@x
uitvouwen	'Y+t-fA+-w@
uitwonend	Y+t-'wo-n@nt
uitzendbureau	'Y+t-sEnd-by-ro
uitzendbureaus	'Y+t-sEnd-by-ros
uitzenden	'Y+t-sEn-d@
uitzoeken	'Y+t-su-k@
uitzonderinggeval	'Y+t-zOn-d@r-IN-G@-vAl
uni	'y-ni
universiteit	y-ni-vEr-zi-'tE+t
unwa	Yn-'wa
up	'Yp
uren	'y-r@
usb-stick	y-Es-'be-stIk
ut	'Yt
uto-	'y-to
utopieÃ«n	y-to-'pi-j@
utopisch	y-'to-pis
utrecht	'y-trExt
uur	'yr
uurtje	'yr-tj@
uurtjes	'yr-tj@s
v	've
v-	'v
va	'va
va-	'va
vaag	'vax
vaak	'vak
vaardigheden	'var-d@x-he-d@
vacatures	va-ka-'ty-r@s
vader	'va-d@r
vage	'va-G@
vak	'vAk
vakantie	va-'kAn-si
vakanties	va-'kAn-sis
vaker	'va-k@r
vakje	'vAk-j@
vakken	'vA-k@
vakkenpakket	'vA-k@-pA-kEt
val	'vAl
vallen	'vA-l@
valt	'vAlt
van	'vAn
vanaf	vAn-'Af
vanavond	vAn-'a-vOnt
vanbinnen	vAm-'bI-n@
vandaa-	vAn-'da
vandaag	vAn-'dax
vandaan	vAn-'dan
vanmiddag	vAn-'mI-dAx
vanmorgen	vAn-'mOr-G@
vannacht	vA-'nAxt
vanochtend	vAn-'Ox-t@nt
vanuit	vAn-'Y+t
vanwege	vAn-'we-G@
vanzelf	vAn-'zElf
varken	'vAr-k@
varkens	'vAr-k@ns
varkensvlees	'vAr-k@s-fles
vas	'vas
vas-	'vAs
vast	'vAst
vaste	'vAs-t@
vastgebonden	'vAst-x@-bOn-d@
vastgemaakt	'vAst-x@-makt
vasthoudt	'vAst-hA+t
vastplakken	'vAst-plA-k@
vat	'vAt
vatbaar	'vAd-bar
v-berekent	f-b@-'re-k@nt
ve-	've
veel	'vel
veertien	'ver-tin
veertig	'ver-t@x
-veertig	'ver-t@x
veilig	'vE+-l@x
vent	'vEnt
ventilatie	vEn-ti-'la-tsi
veolia	ve-'o-li-a
ver	'vEr
ver-	'vEr
vera	've-ra
veranderd	v@r-'An-d@rt
veranderen	v@r-'An-d@-r@
verandering	v@r-'An-d@-rIN
veranderlijke	v@r-'An-d@r-l@-k@
verandert	v@r-'An-d@rt
verantwoordelijk	v@r-Ant-'wor-d@-l@k
verantwoordelijkheid	v@r-Ant-'wor-d@-l@k-hE+t
verbaast	v@r-'bast
verblijven	v@r-'blE+-v@
verboden	v@r-'bo-d@
verbouwen	v@r-'bA+-w@
verbrand	v@r-'brAnt
verbranden	v@r-'brAn-d@
verbrandt	v@r-'brAnt
verbs	'wErbs
verchroomd	v@r-'Gromt
verdeeld	v@r-'delt
verdelen	v@r-'de-l@
verder	'vEr-d@r
verdienen	v@r-'di-n@
verdient	v@r-'dint
verdiep	v@r-'dip
verdieping	v@r-'di-pIN
verdoen	v@r-'dun
verdoezeld	v@r-'du-z@lt
verdomme	v@r-'dO-m@
verdraagzaamheid	v@r-'drax-sam-hE+t
verdwenen	v@r-'dwe-n@
vereniging	v@-'re-n@-GIN
verenigingen	v@-'re-n@-GI-N@
verenigingslijst	v@-'re-nI-GINs-lE+st
verf	'vErf
vergaderd	v@r-'Ga-d@rt
vergadering	v@r-'Ga-d@-rIN
vergeet	v@r-'Get
vergeleken	v@r-G@-'le-k@
vergelijkbaar	v@r-G@-'lE+g-bar
vergelijken	v@r-G@-'lE+-k@
vergeten	v@r-'Ge-t@
vergunningen	v@r-'GY-nI-N@
verhaal	v@r-'hal
verhalen	v@r-'ha-l@
verheugen	v@r-'h2-G@
verhuren	v@r-'hy-r@
verjaardag	v@r-'jar-dAx
verkeerd	v@r-'kert
verknipt	v@r-'knIpt
verlaten	v@r-'la-t@
verleden	v@r-'le-d@
verlichting	v@r-'lIx-tIN
verlies	v@r-'lis
verlimburgs	v@r-'lIm-bYrGs
verloofd	v@r-'loft
verloren	v@r-'lo-r@
vermaak	v@r-'mak
vermakelijk	v@r-'ma-k@-l@k
vermoed	v@r-'mut
vermoeid	v@r-'mujt
vermoeiend	v@r-'mu-j@nt
vermogen	v@r-'mo-G@
vermoord	v@r-'mort
vermplichte	vErm-'plIx-t@
veronica	v@-'ro-ni-ka
veroorzaakt	v@r-'or-zakt
verpakking	v@r-'pA-kIN
verpieteren	v@r-'pi-t@-r@
verplicht	v@r-'plIxt
verschil	v@r-'sxIl
verschillen	v@r-'sxI-l@
verschillend	v@r-'sxI-l@nt
verschillende	v@r-'sxI-l@n-d@
verschoof	v@r-'sxof
verschrikkelijk	v@r-'sxrI-k@-l@k
versie	'vEr-zi
versieren	v@r-'si-r@
verslag	v@r-'slAx
verslagen	v@r-'sla-G@
verslepen	v@r-'sle-p@
verspreid	v@r-'sprE+t
verspreiden	v@r-'sprE+-d@
verspringen	'vEr-sprI-N@
verstaat	v@r-'stat
verstandig	v@r-'stAn-d@x
verstevigen	v@r-'ste-v@-G@
verstoppen	v@r-'stO-p@
verstopt	v@r-'stOpt
vert-	'vErt
vertel	v@r-'tEl
verteld	v@r-'tElt
vertelde	v@r-'tEl-d@
vertellen	v@r-'tE-l@
vertelt	v@r-'tElt
vertikt	v@r-'tIkt
vertraging	v@r-'tra-GIN
vertrekken	v@r-'trE-k@
vertrokken	v@r-'trO-k@
vertrouwen	v@r-'trA+-w@
verval	v@r-'vAl
vervallen	v@r-'vA-l@
vervangen	v@r-'vA-N@
vervanging	v@r-'vA-NIN
vervangt	v@r-'vANt
vervelend	v@r-'ve-l@nt
vervelt	v@r-'vElt
ver-verandert	fEr-fEr-'an-d@rt
ververst	v@r-'vErst
vervolg	v@r-'vOlx
vervolgens	v@r-'vOl-G@ns
verw-	'v@rw
verwacht	v@r-'wAxt
verwachten	v@r-'wAx-t@
verwerkingstijd	v@r-'wEr-kINs-tE+t
verwerpelijk	v@r-'wEr-p@-l@k
verwijderd	v@r-'wE+-d@rt
verwijt	v@r-'wE+t
verwoorden	v@r-'wor-d@
verzetten	v@r-'zE-t@
verzinnen	v@r-'zI-n@
verzonnen	v@r-'zO-n@
verzuurd	v@r-'zyrt
vest	'vEst
vestje	'vEst-j@
vestjes	'vEst-j@s
vet	'vEt
vetste	'vEt-st@
vette	'vE-t@
vi	'vi
vi-	'vi
via	'vi-ja
vicky	'vI-ki
video	'vi-de-jo
video's	'vi-de-jos
videotheek	vi-de-jo-'tek
vie	'vi
vie-	'vi
viel	'vil
vielen	'vi-l@
vier	'vir
vierdaagse	vir-'dax-s@
vieren	'vi-r@
vierenhalf	vir-@n-'hAlf
vierenveertig	vi-r@-'ver-t@x
vierhonderd	'vir-hOn-d@rt
vierhonderdvierentwintig	vir-hOn-d@rt-'vi-r@n-twIn-t@x
vierkant	'vir-kAnt
vies	'vis
viezigheid	'vi-z@x-hE+t
vijf	'vE+f
vijfdaagse	'vE+v-dax-s@
vijfde	'vE+v-d@
vijfduizend	'vE+v-dY+-z@nt
vijfendertig	'vE+f-En-dEr-t@x
vijfentwintig	'vE+f-En-twIn-t@x
vijfenveertig	'vE+-fE-ver-t@x
vijftien	'vE+f-tin
vijftiende	'vE+f-tin-d@
vijftig	'vE+f-t@x
vijven	'vE+-v@
vijver	'vE+-v@r
villa	'vi-la
villafeest	'vI-la-fest
vin	'vIn
vin-	'vIn
vincentius	vI-'sEn-si-jYs
vind	'vInt
vinden	'vIn-d@
vindt	'vInt
vinger	'vI-N@r
viola	vi-'jo-la
vip-ticket	We-Aj-'pe-tI-k@t
virtual	'v2r-tjY-wAl
virussen	'vi-rY-s@
visies	'vi-zis
vissen	'vI-s@
vivaldi	vi-'vAl-di
vlak	'vlAk
vlakke	'vlA-k@
vlammen	'vlA-m@
vlammenwerper	'vlA-m@n-wEr-p@r
vlees	'vles
vlekken	'vlE-k@
vliegen	'vli-G@
vlot	'vlOt
vlucht	'vlYxt
vo-	'vo
vochtig	'vOx-t@x
voeden	'vu-d@
voegt	'vuxt
voel	'vul
voelde	'vul-d@
voelden	'vul-d@
voelen	'vu-l@
voelt	'vult
voer	'vur
voeren	'vu-r@
voetbal	'vud-bAl
voetbalde	'vud-bAl-d@
voetballers	'vud-bA-l@rs
voetballetje	'vut-bA-l@t-j@
voetbalwedstrijd	'vud-bAl-wEt-strE+t
voetvalwedstrijd	'vut-vAl-wEd-strE+t
voicemail	'vOjs-mel
voicemails	'vOjs-mejls
vol	'vOl
voldoende	vOl-'dun-d@
voldoet	vOl-'dut
volgen	'vOl-G@
volgend	'vOl-G@nt
volgende	'vOl-G@n-d@
volgens	'vOl-G@ns
volgorde	'vOlG-Or-d@
volgt	'vOlxt
volhouden	'vOl-hA+-d@
volk	'vOlk
volksheld	'vOlks-hElt
volkskrant	'vOlks-krAnt
volkskrantartikel	'vOlks-krAnt-Ar-ti-k@l
volle	'vO-l@
volledige	vO-'le-d@-G@
vond	'vOnt
vonden	'vOn-d@
voor	'vor
vooraan	vor-'an
vooral	vor-'Al
voorbeeld	'vor-belt
voorbereiden	'vor-b@-rE+-d@
voorbij	vor-'bE+
voordat	vor-'dAt
voordat-voordat	'vor-dAt-vor-dAt
voordeel	'vor-del
voorgaande	'vor-Gan-d@
voorkant	'vor-kAnt
voorkeur	'vor-k2r
voorkomen	vor-'ko-m@
voorlopige	vor-'lo-p@-G@
voorn	'vor-@n
voornaam	'vor-nam
voorpagina	'vor-pa-Gi-na
voorproefje	'vor-pruf-j@
voorraad	'vo-rat
voorraadbriefjes	'vo-rat-brif-j@s
voorraaddingen	'vo-rat-dI-N@n
voorstellen	'vor-stE-l@
voorstelling	'vor-stE-lIN
voort	'vort
voortgezet	'vort-x@-zEt
vooruit	vor-'Y+t
vooruitgang	vor-'Y+t-xAN
voor-voor	'vor-vor
voorwaarde	'vor-war-d@
voorzitter	'vor-zI-t@r
voren	'vo-r@
vorig	'vo-r@x
vorig-	'vo-r@G
vorige	'vo-r@-G@
vorm	'vOrm
vormden	'vOrm-d@
vo-voor	vo-'vor
vo-vorige	vo-'vo-rI-g@
vr-	'vr
vraag	'vrax
vragen	'vra-G@
vreemd	'vremt
vrien-	'vrin
vriend	'vrint
vrienden	'vrin-d@
vriendengroep	'vrin-d@-Grup
vriendin	vrin-'dIn
vriendjespolitiek	'vrint-j@s-po-li-tik
vrij	'vrE+
vrijdag	'vrE+-dAx
vrijdagavond	'vrE+-dAG-a-vOnt
vrijdagochtend	'vrE+-dAx-Ox-t@nt
vrijeschool	vrE+-j@-'sxol
vrijmarkt	'vrE+-mArkt
vroeg	'vrux
vroeger	'vru-G@r
vrolijker	'vro-l@-k@r
vrouw	'vrA+w
vrouwen	'vrA+-w@
vrouwenemancipatie	'vrA+-w@-e-mAn-si-pa-tsi
vrouwtje	'vrA+w-tj@
vullen	'vY-l@
vuur	'vyr
v-vaag	v-'vag
v-vaak	v-'vak
v-vaarwater	v-'var-wa-t@r
v-van	v-vAn
v-vandaag	f-fAn-'daG
vvd	ve-ve-'de
v-vertrouwde	v-v@r-'trA+w-d@
v-vincentius	v-vIn-'cEn-ti-jus
v-vlam	v-'vlAm
v-volgende	v-'vOl-G@n-d@
v-voor	f-'for
v-vriendjes	v-'vrin-tj@s
v-v-verwisselen	v-v-vEr-'wI-s@-l@n
v-v-v-v-	'v-v-v-v-
w	'w
w-	'w
wa	'wa
wa-	'wa
waalstraat	'wal-strat
waalwijk	'wal-wE+k
waanzinnig	wan-'zI-n@x
waar	'war
waarbij	war-'bE+
waard	'wart
waarde	'war-d@
waardevol	'war-d@-vOl
waarin	war-'In
waarmee	war-'me
waarneemt	'war-nemt
waarnemen	'war-ne-m@
waarom	war-'Om
waarschijnlijk	war-'sxE+n-l@k
waarvan	war-'vAn
waarvoor	war-'vor
waarvoot	war-'vot
waas	'was
wa-as	'wa-as
wacht	'wAxt
wachten	'wAx-t@
wah	'wA
wahal	wA-'hal
wai	'wAj
wak	'wAk
wak-	'wAk
wakker	'wA-k@r
walking	'wa-kIN
walkman	'wO:k-mEn
wam	'wAm
wandelaar	'wAn-d@-lar
wandelaars	'wAn-d@-lars
wandelen	'wAn-d@-l@
wanden	'wAn-d@
wann-	'wAn
wanneer	wA-'ner
want	'wAnt
wan-want	wAn-'wAnt
war	'wAr
ware	'wa-r@
waren	'wa-r@
warm	'wArm
was	'wAs
wasmachine	'wAs-mA-Si-n@
wasmand	'wAs-mAnt
waspik	'wAs-pIk
wassen	'wA-s@
was-s-s	'wAs-s-s
wat	'wAt
water	'wa-t@r
watervast	'wa-t@r-vAst
watervaste	wa-t@r-'vAs-t@
wat-wat	'wAt-wAt
wauw	'wA+w
wa-waren	wa-'wa-r@n
wa-was	wA-'wAs
wc	we-'se
wc-mat	we-'se-mAt
wc's	we-'ses
we	'w@
we-	'w@
weds-	'wEds
wedstrijd	'wEt-strE+t
wedstrijden	'wEt-strE+-d@
wedstrijdje	'wEt-strE+t-j@
wedstrijdroeien	'wEt-strE+d-ru-j@
wedstrijdroeier	'wEd-strE+t-ru-j@r
wedstrijdroeiers	'wEt-strE+d-ru-j@rs
wee	'we
wee-	'we
weegde	'weG-d@
weegner	'wek-n@r
week	'wek
weekblad	'weg-blAt
weekend	'wi-kEnt
weekendje	'wi-kEnt-j@
weekje	'wek-j@
weer	'wer
weerskanten	'wers-kAn-t@
weerspiegelt	wer-'spi-G@lt
weertje	'wer-tj@
wees	'wes
weet	'wet
weg	'wEG
wegener	'we-Ge-n@r
weggaan	'wE-Gan
weggaat	'wE-Gat
weggekeken	'wE-G@-ke-k@
weggestopt	'wE-G@-stOpt
weggetikt	'wE-G@-tIkt
weggezet	'wE-G@-zEt
wegleggen	'wEG-lE-G@
wei	'wE+
wei-	'wE+
weigeren	'wE+-G@-r@
weinig	'wE+-n@x
weken	'we-k@
wekt	'wEkt
wel	'wEl
welk	'wElk
welk-	'wElk
welke	'wEl-k@
wel-wel	'wEl-wEl
wenen	'we-n@
wennen	'wE-n@
went	'wEnt
werd	'wErt
werden	'wEr-d@
wereld	'we-r@lt
wereldleiders	'we-r@lt-lE+-d@rs
wereldoorlog	'we-r@ld-or-lOx
werk	'wErk
werkcollege	'wEr-kO-le-Z@
werkcolleges	'wEr-kO-le-Z@s
werkelijk	'wEr-k@-l@k
werken	'wEr-k@
werkende	'wEr-k@n-d@
-werkende	'wEr-k@n-d@
werkgroep	'wErk-xrup
werkgroepen	'wErk-xru-p@
werkt	'wErkt
werkte	'wErk-t@
werkweek	'wErk-wek
werkwoorden	'wErk-wor-d@
westers	'wEs-t@rs
weten	'we-t@
wetenschap	'we-t@-sxAp
wetenschapfeest	'we-t@n-sxAp-fest
wetenschappen	'we-t@-sxA-p@
wetenschapsfraudeur	'we-t@n-sxAps-frA+-d2r
weu	'w2
we-we	'wE-wE
wezen	'we-z@
what	'whAt
what's	'wAts
whatsapp	wAt-'sAp
whisky-cola	wIs-ki-'ko-la
wi	'wi
wi-	'wi
wibra	'wi-bra
wie	'wi
wielrenfietsen	'wil-rEn-fIt-s@n
wielrennen	'wil-rE-n@
wiet	'wit
wie-wie	'wi-wi
wij	'wE+
wijn	'wE+n
wijze	'wE+-z@
wil	'wIl
wild	'wIlt
wilde	'wIl-d@
wilden	'wIl-d@
wilke	'wI-lk@
wille	'wI-l@
wille-	'wI-l@
willem	'wI-lEm
willemien	wI-l@-'mi
willempie	'wI-l@m-pi
willen	'wI-l@
wilt	'wIlt
wil-willen	Wil-'WI-l@n
win	'wIn
winkel	'wIN-k@l
winnaar	'wI-nar
winnen	'wI-n@
wint	'wInt
winter	'wIn-t@r
winterwachten	'wIn-t@r-wAx-t@n
wip	'wIp
wiskunde	'wIs-kYn-d@
wissel	'wI-s@l
wisselen	'wI-s@-l@
wist	'wIst
wit	'wIt
with	'wt
witte	'wI-t@
witteman	'wI-t@-mAn
woensdag	'wunz-dAx
woep	'wup
woh	'wO
wonder	'wOn-d@r
wonen	'wo-n@
woning	'wo-nIN
woningen	'wo-nI-N@
woods	'wots
woog	'wox
woon	'won
woonde	'won-d@
woont	'wont
woord	'wort
woorden	'wor-d@
woordspelletje	'word-spE-l@-tj@
word	'wOrt
worden	'wOr-d@
wordt	'wOrt
workaholics	wYrk-A-'hO-lIks
workshop	'wYrk-SOp
wou	'wA+w
wouden	'wA+-d@
wouter	'wA+-t@r
wow	'wA+
wrong	'wrON
wuh	'wY+
w-v-meer	w-v-'mer
ww	'wewe
w-w-	'w-w
w-waar	w-'war
w-waarom	w-wa-'rOm
w-wandelen	w-'wAn-d@-l@n
w-wanneer	w-wA-'ner
w-want	w-'wAnt
w-was	w-'wAs
w-wat	w-'wAt
w-wat-t	w-'wAt-t
w-weer	w-'wer
w-weet	w-'wet
w-wel	w-'wEl
w-weten	w-'we-t@n
w-wij	w-'wE+
wzz	'wzz
xenos	'Ie-nos
xenos-idee	'kse-nOs-i-de
xxl	Iks-Iks-'El
yeah	'jia
yes	'jEs
you	'E+A+
young	'E+A+N
z	'zEt
z-	'z
za-	'za
zaak	'zak
zaal	'zal
zaaltje	'zal-tj@
zaalvoetbal	'zal-vud-bAl
zaalvoetbalvereniging	'zal-fut-bAl-v@-re-n@-GIN
zag	'zAx
zagen	'za-G@
zak	'zAk
zakcentje	'zAk-sEn-tj@
zakje	'zAk-j@
zakjes	'zAk-j@s
zal	'zAl
zalen	'za-l@
zand	'zAnt
zanger	'zA-N@r
zangeres	zA-N@-'rEs
zat	'zAt
zaten	'za-t@
zaterdag	'za-t@r-dAx
zaterdagavond	za-t@r-dAG-'a-vOnt
zaterdagmiddag	'za-t@r-dAG-mI-dAx
zaterd-dag	'za-t@r-dAG
ze	'z@
ze-	'zE
zee	'ze
zeek	'zek
zeek-	'zek
zeer	'zer
zeg	'zEx
zeg-	'zEG
zeggen	'zE-G@
zegt	'zExt
zei	'zE+
zeiden	'zE+-d@
zeik	'zE+k
zeiken	'zE+-k@
zeikt	'zE+kt
zeikte	'zE+k-t@
zeker	'ze-k@r
zekers	'ze-k@rs
zel-	'zEl
zelf	'zElf
zelfde	'zElv-d@
zelfs	'zElfs
zelfstandig	zElf-'stAn-d@x
zelve	'zEl-v@
zen	'z@
zen-	'zEn
zenden	'zEn-d@
zender	'zEn-d@r
zes	'zEs
zesentwintig	'zEz-En-twIn-t@x
zesenvijftig	'zE-z@-vE+f-t@x
zestien	'zEs-tin
zestiende	'zEs-tin-d@
zestig	'zEs-t@x
zet	'zEt
zetten	'zE-t@
zeven	'ze-v@
zeventien	'ze-v@n-tin
zeventiende	'ze-v@n-tin-d@
zeventig	'ze-v@n-t@x
ze-ze	'zE-zE
zi-	'zi
zich	'zIx
zichzelf	zIx-'sElf
zie	'zi
ziekenhuis	'zi-k@-hY+s
zielig	'zi-l@x
zien	'zin
ziet	'zit
zigzagachtig	'zIG-zAG-Ax-t@x
zij	'zE+
zij-	'zE+
zijkant	'zE+-kAnt
zijn	'zE+n
zijn-zijn	'zE+n-zE+n
zij-zijn	zE+-'zE+n
zin	'zIn
zit	'zIt
zitten	'zI-t@
zittend	'zI-t@nt
zi-zit	zI-'zIt
z'n	'z@n
zündapp	'zYn-dAp
zo	'zo
zoë	'zu
zoals	zo-'wAls
zodat	zo-'dAt
zodra	zo-'dra
zoÃ«	zu
zoek	'zuk
zoeken	'zu-k@
-zoeksvraagstelling	'zuks-fraG-stE-lIN
zoekt	'zukt
zoiets	'zo-wits
zolang	zo-'lAN
zolder	'zOl-d@r
zolderkamer	'zOl-d@r-ka-m@r
zomaar	'zo-mar
zombie	'zOm-bi
zomer	'zo-m@r
zomerfeest	'zo-m@r-fest
zomerfeesten	'zo-m@r-fes-t@
zomervakantie	'zo-m@r-va-kAn-si
zon	'zOn
zo'n	'zon
zond	'zOnt
zondag	'zOn-dAx
zondagavond	'zOn-dAG-a-vOnt
zonde	'zOn-d@
zonder	'zOn-d@r
zong	'zON
zonnebril	'zO-n@-brIl
zonnebrillen	'zO-n@-brI-l@
zooi	'zoj
zook	'zok
zool	'zol
zoon	'zon
zorg	'zOrx
zorgen	'zOr-G@
zorgwekkend	zOrG-'wE-k@nt
zou	'zA+w
zouden	'zA+-d@
zoveel	zo-'vel
zoverre	zo-'vE-r@
zowat	zo-'wAt
zozeer	zo-'zer
zozo	'zo-zo
zo-zo	'zo-zo
zo-zoals	so-so-'Als
zu	'zy
zu-	'zy
zuidas	'zY+t-As
zuipen	'zY+-p@
zuipt	'zY+pt
zul	'zYl
zulk	'zYlk
zulke	'zYl-k@
zullen	'zY-l@
zult	'zYlt
zÃŒndapp	zYndAp
zus	'zYs
zussen	'zY-s@
zuur	'zyr
zuurdesembrood	'zyr-de-s@m-brot
zv	'zv
zw	zEt-'we
zw-	'zw
zwaar	'zwar
zware	'zwa-r@
zwart	'zwArt
zwarte	'zwAr-t@
zwartste	'zwArt-st@
zweet	'zwet
zwembad	'zwEm-bAt
zwemmen	'zwE-m@
zwolle	'zwO-l@
zz-	'z
z-ze	z-'zE
z-zeventien	z-'ze-v@n-tin
z-zitten	z-'zI-t@n
z-zo	z-'zo
z-zulke	z-'zYl-k@
