sprei	sprei
Suzan	sysacn
gele	xel@
laken	lak@n
echtpaar	ecxtpar
adopteert	acdocptirt
tweejarig	twejar@x
weesje	wesj@
Jeannette	z@nect
onbekende	ocnb@kecnd@
gekust	x@kust
wielerfestijn	wil@rfecstein
verbruikte	fecrbruikt@
Dries	dris
deodorant	deodocracnt
onverharde	ocnfecrhacrd@
DVD	defede
heus	heus
opzichten	ocpsicxt@n
pistool	pistol
toveren	tof@r@n
takt	tackt
verwart	fecrwacrt
erudiet	erydit
knort	knocrt
varken	facrk@n
wei	wei
karakteristiek	karackt@r@stik
