sprei	sprE+
Suzan	sysAn
gele	xel@
laken	lak@n
echtpaar	Extpar
adopteert	AdOptirt
tweejarig	twejar@x
weesje	wesj@
Jeannette	Z@nEt
onbekende	Onb@kEnd@
gekust	x@kust
wielerfestijn	wil@rfEstE+n
verbruikte	fErbrY+kt@
Dries	dris
deodorant	deodOrAnt
onverharde	OnfErhArd@
DVD	defede
heus	hCs
opzichten	OpsIxt@n
pistool	pistol
toveren	tof@r@n
takt	tAkt
verwart	fErwArt
erudiet	erydit
knort	knOrt
varken	fArk@n
wei	wE+
karakteristiek	karAkt@r@stik
